Age	Discharged	On-going care	Died	Total	date	gender
0-4	193	10	0	203	2021-02-04	female
5-9	55	9	0	64	2021-02-04	female
10-14	93	17	0	110	2021-02-04	female
15-19	226	28	3	257	2021-02-04	female
20-24	447	49	2	498	2021-02-04	female
25-29	646	93	7	746	2021-02-04	female
30-34	829	111	6	946	2021-02-04	female
35-39	710	125	16	851	2021-02-04	female
40-44	618	114	20	752	2021-02-04	female
45-49	777	147	40	964	2021-02-04	female
50-54	1090	196	69	1355	2021-02-04	female
55-59	1221	243	116	1580	2021-02-04	female
60-64	1094	292	163	1549	2021-02-04	female
65-69	1108	330	246	1684	2021-02-04	female
70-74	1318	524	474	2316	2021-02-04	female
75-79	1412	598	585	2595	2021-02-04	female
80-84	1472	861	768	3101	2021-02-04	female
85-89	1357	824	801	2982	2021-02-04	female
90+	1042	742	801	2585	2021-02-04	female
0-4	264	27	2	293	2021-02-04	male
5-9	51	8	0	59	2021-02-04	male
10-14	103	15	0	118	2021-02-04	male
15-19	121	22	0	143	2021-02-04	male
20-24	167	39	2	208	2021-02-04	male
25-29	246	79	4	329	2021-02-04	male
30-34	462	75	6	543	2021-02-04	male
35-39	579	111	14	704	2021-02-04	male
40-44	752	141	32	925	2021-02-04	male
45-49	1112	248	67	1427	2021-02-04	male
50-54	1471	300	98	1869	2021-02-04	male
55-59	1632	404	185	2221	2021-02-04	male
60-64	1657	431	329	2417	2021-02-04	male
65-69	1515	542	448	2505	2021-02-04	male
70-74	1825	683	808	3316	2021-02-04	male
75-79	1723	780	991	3494	2021-02-04	male
80-84	1570	813	1168	3551	2021-02-04	male
85-89	1083	751	1097	2931	2021-02-04	male
90+	566	474	805	1845	2021-02-04	male
0-4	457	37	2	496	2021-02-04	all
5-9	106	17	0	123	2021-02-04	all
10-14	196	32	0	228	2021-02-04	all
15-19	347	50	3	400	2021-02-04	all
20-24	614	88	4	706	2021-02-04	all
25-29	892	172	11	1075	2021-02-04	all
30-34	1291	186	12	1489	2021-02-04	all
35-39	1289	236	30	1555	2021-02-04	all
40-44	1370	255	52	1677	2021-02-04	all
45-49	1889	395	107	2391	2021-02-04	all
50-54	2561	496	167	3224	2021-02-04	all
55-59	2853	647	301	3801	2021-02-04	all
60-64	2751	723	492	3966	2021-02-04	all
65-69	2623	872	694	4189	2021-02-04	all
70-74	3143	1207	1282	5632	2021-02-04	all
75-79	3135	1378	1576	6089	2021-02-04	all
80-84	3042	1674	1936	6652	2021-02-04	all
85-89	2440	1575	1898	5913	2021-02-04	all
90+	1608	1216	1606	4430	2021-02-04	all
0-4	195	10	0	205	2021-02-05	female
5-9	55	10	0	65	2021-02-05	female
10-14	94	17	0	111	2021-02-05	female
15-19	228	28	3	259	2021-02-05	female
20-24	453	50	2	505	2021-02-05	female
25-29	656	93	7	756	2021-02-05	female
30-34	837	113	7	957	2021-02-05	female
35-39	723	125	16	864	2021-02-05	female
40-44	636	115	20	771	2021-02-05	female
45-49	791	148	41	980	2021-02-05	female
50-54	1110	201	70	1381	2021-02-05	female
55-59	1241	245	118	1604	2021-02-05	female
60-64	1109	295	169	1573	2021-02-05	female
65-69	1134	345	251	1730	2021-02-05	female
70-74	1350	530	484	2364	2021-02-05	female
75-79	1436	607	596	2639	2021-02-05	female
80-84	1499	874	775	3148	2021-02-05	female
85-89	1380	845	817	3042	2021-02-05	female
90+	1063	761	818	2642	2021-02-05	female
0-4	267	28	2	297	2021-02-05	male
5-9	51	8	0	59	2021-02-05	male
10-14	103	15	0	118	2021-02-05	male
15-19	121	22	0	143	2021-02-05	male
20-24	170	40	2	212	2021-02-05	male
25-29	251	79	4	334	2021-02-05	male
30-34	468	77	6	551	2021-02-05	male
35-39	584	114	15	713	2021-02-05	male
40-44	774	142	33	949	2021-02-05	male
45-49	1130	251	67	1448	2021-02-05	male
50-54	1496	306	99	1901	2021-02-05	male
55-59	1661	410	190	2261	2021-02-05	male
60-64	1691	442	337	2470	2021-02-05	male
65-69	1543	548	461	2552	2021-02-05	male
70-74	1862	693	820	3375	2021-02-05	male
75-79	1760	798	1009	3567	2021-02-05	male
80-84	1594	826	1189	3609	2021-02-05	male
85-89	1102	770	1109	2981	2021-02-05	male
90+	572	481	824	1877	2021-02-05	male
0-4	462	38	2	502	2021-02-05	all
5-9	106	18	0	124	2021-02-05	all
10-14	197	32	0	229	2021-02-05	all
15-19	349	50	3	402	2021-02-05	all
20-24	623	90	4	717	2021-02-05	all
25-29	907	172	11	1090	2021-02-05	all
30-34	1305	190	13	1508	2021-02-05	all
35-39	1307	239	31	1577	2021-02-05	all
40-44	1410	257	53	1720	2021-02-05	all
45-49	1921	399	108	2428	2021-02-05	all
50-54	2606	507	169	3282	2021-02-05	all
55-59	2902	655	308	3865	2021-02-05	all
60-64	2800	737	506	4043	2021-02-05	all
65-69	2677	893	712	4282	2021-02-05	all
70-74	3212	1223	1304	5739	2021-02-05	all
75-79	3196	1405	1605	6206	2021-02-05	all
80-84	3093	1700	1964	6757	2021-02-05	all
85-89	2482	1615	1926	6023	2021-02-05	all
90+	1635	1242	1642	4519	2021-02-05	all
0-4	198	10	0	208	2021-02-06	female
5-9	55	10	0	65	2021-02-06	female
10-14	95	17	0	112	2021-02-06	female
15-19	230	28	3	261	2021-02-06	female
20-24	456	51	2	509	2021-02-06	female
25-29	664	95	7	766	2021-02-06	female
30-34	842	116	7	965	2021-02-06	female
35-39	731	125	16	872	2021-02-06	female
40-44	645	119	22	786	2021-02-06	female
45-49	807	148	42	997	2021-02-06	female
50-54	1130	204	73	1407	2021-02-06	female
55-59	1261	250	119	1630	2021-02-06	female
60-64	1122	299	171	1592	2021-02-06	female
65-69	1143	349	254	1746	2021-02-06	female
70-74	1367	536	496	2399	2021-02-06	female
75-79	1461	618	612	2691	2021-02-06	female
80-84	1520	890	789	3199	2021-02-06	female
85-89	1412	859	830	3101	2021-02-06	female
90+	1081	775	835	2691	2021-02-06	female
0-4	270	28	2	300	2021-02-06	male
5-9	53	8	0	61	2021-02-06	male
10-14	104	15	0	119	2021-02-06	male
15-19	122	23	0	145	2021-02-06	male
20-24	173	42	2	217	2021-02-06	male
25-29	253	80	4	337	2021-02-06	male
30-34	480	78	6	564	2021-02-06	male
35-39	592	116	15	723	2021-02-06	male
40-44	790	143	34	967	2021-02-06	male
45-49	1151	256	69	1476	2021-02-06	male
50-54	1520	312	102	1934	2021-02-06	male
55-59	1692	414	196	2302	2021-02-06	male
60-64	1715	445	343	2503	2021-02-06	male
65-69	1564	552	472	2588	2021-02-06	male
70-74	1885	703	830	3418	2021-02-06	male
75-79	1788	813	1030	3631	2021-02-06	male
80-84	1621	841	1204	3666	2021-02-06	male
85-89	1121	787	1127	3035	2021-02-06	male
90+	581	486	836	1903	2021-02-06	male
0-4	468	38	2	508	2021-02-06	all
5-9	108	18	0	126	2021-02-06	all
10-14	199	32	0	231	2021-02-06	all
15-19	352	51	3	406	2021-02-06	all
20-24	629	93	4	726	2021-02-06	all
25-29	917	175	11	1103	2021-02-06	all
30-34	1322	194	13	1529	2021-02-06	all
35-39	1323	241	31	1595	2021-02-06	all
40-44	1435	262	56	1753	2021-02-06	all
45-49	1958	404	111	2473	2021-02-06	all
50-54	2650	516	175	3341	2021-02-06	all
55-59	2953	664	315	3932	2021-02-06	all
60-64	2837	744	514	4095	2021-02-06	all
65-69	2707	901	726	4334	2021-02-06	all
70-74	3252	1239	1326	5817	2021-02-06	all
75-79	3249	1431	1642	6322	2021-02-06	all
80-84	3141	1731	1993	6865	2021-02-06	all
85-89	2533	1646	1957	6136	2021-02-06	all
90+	1662	1261	1671	4594	2021-02-06	all
0-4	198	10	0	208	2021-02-07	female
5-9	55	10	0	65	2021-02-07	female
10-14	95	17	0	112	2021-02-07	female
15-19	232	28	3	263	2021-02-07	female
20-24	457	51	2	510	2021-02-07	female
25-29	664	95	7	766	2021-02-07	female
30-34	843	116	7	966	2021-02-07	female
35-39	733	125	16	874	2021-02-07	female
40-44	646	119	22	787	2021-02-07	female
45-49	809	148	43	1000	2021-02-07	female
50-54	1134	204	73	1411	2021-02-07	female
55-59	1266	251	119	1636	2021-02-07	female
60-64	1128	301	174	1603	2021-02-07	female
65-69	1145	349	256	1750	2021-02-07	female
70-74	1371	537	502	2410	2021-02-07	female
75-79	1467	619	613	2699	2021-02-07	female
80-84	1525	892	791	3208	2021-02-07	female
85-89	1413	860	831	3104	2021-02-07	female
90+	1086	777	837	2700	2021-02-07	female
0-4	270	28	2	300	2021-02-07	male
5-9	53	8	0	61	2021-02-07	male
10-14	104	15	0	119	2021-02-07	male
15-19	122	23	0	145	2021-02-07	male
20-24	173	42	2	217	2021-02-07	male
25-29	255	80	4	339	2021-02-07	male
30-34	483	78	6	567	2021-02-07	male
35-39	596	117	15	728	2021-02-07	male
40-44	794	143	34	971	2021-02-07	male
45-49	1153	256	69	1478	2021-02-07	male
50-54	1528	313	102	1943	2021-02-07	male
55-59	1697	415	196	2308	2021-02-07	male
60-64	1721	445	345	2511	2021-02-07	male
65-69	1567	553	472	2592	2021-02-07	male
70-74	1888	704	831	3423	2021-02-07	male
75-79	1791	816	1030	3637	2021-02-07	male
80-84	1624	846	1207	3677	2021-02-07	male
85-89	1123	787	1133	3043	2021-02-07	male
90+	585	487	839	1911	2021-02-07	male
0-4	468	38	2	508	2021-02-07	all
5-9	108	18	0	126	2021-02-07	all
10-14	199	32	0	231	2021-02-07	all
15-19	354	51	3	408	2021-02-07	all
20-24	630	93	4	727	2021-02-07	all
25-29	919	175	11	1105	2021-02-07	all
30-34	1326	194	13	1533	2021-02-07	all
35-39	1329	242	31	1602	2021-02-07	all
40-44	1440	262	56	1758	2021-02-07	all
45-49	1962	404	112	2478	2021-02-07	all
50-54	2662	517	175	3354	2021-02-07	all
55-59	2963	666	315	3944	2021-02-07	all
60-64	2849	746	519	4114	2021-02-07	all
65-69	2712	902	728	4342	2021-02-07	all
70-74	3259	1241	1333	5833	2021-02-07	all
75-79	3258	1435	1643	6336	2021-02-07	all
80-84	3149	1738	1998	6885	2021-02-07	all
85-89	2536	1647	1964	6147	2021-02-07	all
90+	1671	1264	1676	4611	2021-02-07	all
0-4	198	10	0	208	2021-02-08	female
5-9	55	10	0	65	2021-02-08	female
10-14	95	17	0	112	2021-02-08	female
15-19	233	28	3	264	2021-02-08	female
20-24	457	51	2	510	2021-02-08	female
25-29	664	95	7	766	2021-02-08	female
30-34	844	116	7	967	2021-02-08	female
35-39	733	125	16	874	2021-02-08	female
40-44	646	119	22	787	2021-02-08	female
45-49	810	148	43	1001	2021-02-08	female
50-54	1136	204	73	1413	2021-02-08	female
55-59	1267	251	119	1637	2021-02-08	female
60-64	1131	301	174	1606	2021-02-08	female
65-69	1146	350	256	1752	2021-02-08	female
70-74	1373	537	502	2412	2021-02-08	female
75-79	1468	621	613	2702	2021-02-08	female
80-84	1528	893	792	3213	2021-02-08	female
85-89	1414	862	833	3109	2021-02-08	female
90+	1086	777	838	2701	2021-02-08	female
0-4	270	28	3	301	2021-02-08	male
5-9	53	8	0	61	2021-02-08	male
10-14	104	15	0	119	2021-02-08	male
15-19	124	23	0	147	2021-02-08	male
20-24	174	42	2	218	2021-02-08	male
25-29	255	81	4	340	2021-02-08	male
30-34	484	78	6	568	2021-02-08	male
35-39	597	117	15	729	2021-02-08	male
40-44	794	143	34	971	2021-02-08	male
45-49	1157	256	69	1482	2021-02-08	male
50-54	1529	313	102	1944	2021-02-08	male
55-59	1697	415	197	2309	2021-02-08	male
60-64	1722	445	345	2512	2021-02-08	male
65-69	1567	553	472	2592	2021-02-08	male
70-74	1891	704	833	3428	2021-02-08	male
75-79	1794	816	1031	3641	2021-02-08	male
80-84	1624	848	1209	3681	2021-02-08	male
85-89	1124	787	1135	3046	2021-02-08	male
90+	586	488	841	1915	2021-02-08	male
0-4	468	38	3	509	2021-02-08	all
5-9	108	18	0	126	2021-02-08	all
10-14	199	32	0	231	2021-02-08	all
15-19	357	51	3	411	2021-02-08	all
20-24	631	93	4	728	2021-02-08	all
25-29	919	176	11	1106	2021-02-08	all
30-34	1328	194	13	1535	2021-02-08	all
35-39	1330	242	31	1603	2021-02-08	all
40-44	1440	262	56	1758	2021-02-08	all
45-49	1967	404	112	2483	2021-02-08	all
50-54	2665	517	175	3357	2021-02-08	all
55-59	2964	666	316	3946	2021-02-08	all
60-64	2853	746	519	4118	2021-02-08	all
65-69	2713	903	728	4344	2021-02-08	all
70-74	3264	1241	1335	5840	2021-02-08	all
75-79	3262	1437	1644	6343	2021-02-08	all
80-84	3152	1741	2001	6894	2021-02-08	all
85-89	2538	1649	1968	6155	2021-02-08	all
90+	1672	1265	1679	4616	2021-02-08	all
0-4	200	10	0	210	2021-02-09	female
5-9	55	10	0	65	2021-02-09	female
10-14	96	17	0	113	2021-02-09	female
15-19	234	30	3	267	2021-02-09	female
20-24	462	52	2	516	2021-02-09	female
25-29	672	98	8	778	2021-02-09	female
30-34	864	114	7	985	2021-02-09	female
35-39	744	126	16	886	2021-02-09	female
40-44	659	119	23	801	2021-02-09	female
45-49	826	152	44	1022	2021-02-09	female
50-54	1162	206	74	1442	2021-02-09	female
55-59	1287	257	124	1668	2021-02-09	female
60-64	1165	303	182	1650	2021-02-09	female
65-69	1166	360	259	1785	2021-02-09	female
70-74	1404	546	511	2461	2021-02-09	female
75-79	1495	633	628	2756	2021-02-09	female
80-84	1557	908	799	3264	2021-02-09	female
85-89	1448	875	848	3171	2021-02-09	female
90+	1112	794	854	2760	2021-02-09	female
0-4	274	29	3	306	2021-02-09	male
5-9	54	9	0	63	2021-02-09	male
10-14	106	17	0	123	2021-02-09	male
15-19	129	24	0	153	2021-02-09	male
20-24	180	47	3	230	2021-02-09	male
25-29	259	83	5	347	2021-02-09	male
30-34	494	81	6	581	2021-02-09	male
35-39	608	115	15	738	2021-02-09	male
40-44	811	149	34	994	2021-02-09	male
45-49	1176	262	69	1507	2021-02-09	male
50-54	1565	323	106	1994	2021-02-09	male
55-59	1741	422	206	2369	2021-02-09	male
60-64	1763	450	357	2570	2021-02-09	male
65-69	1590	564	481	2635	2021-02-09	male
70-74	1918	724	850	3492	2021-02-09	male
75-79	1824	829	1055	3708	2021-02-09	male
80-84	1645	862	1230	3737	2021-02-09	male
85-89	1144	797	1157	3098	2021-02-09	male
90+	602	491	856	1949	2021-02-09	male
0-4	474	39	3	516	2021-02-09	all
5-9	109	19	0	128	2021-02-09	all
10-14	202	34	0	236	2021-02-09	all
15-19	363	54	3	420	2021-02-09	all
20-24	642	99	5	746	2021-02-09	all
25-29	931	181	13	1125	2021-02-09	all
30-34	1358	195	13	1566	2021-02-09	all
35-39	1352	241	31	1624	2021-02-09	all
40-44	1470	268	57	1795	2021-02-09	all
45-49	2002	414	113	2529	2021-02-09	all
50-54	2727	529	180	3436	2021-02-09	all
55-59	3028	679	330	4037	2021-02-09	all
60-64	2928	753	539	4220	2021-02-09	all
65-69	2756	924	740	4420	2021-02-09	all
70-74	3322	1270	1361	5953	2021-02-09	all
75-79	3319	1462	1683	6464	2021-02-09	all
80-84	3202	1770	2029	7001	2021-02-09	all
85-89	2592	1672	2005	6269	2021-02-09	all
90+	1714	1285	1710	4709	2021-02-09	all
0-4	203	10	0	213	2021-02-10	female
5-9	55	10	0	65	2021-02-10	female
10-14	96	18	0	114	2021-02-10	female
15-19	239	31	3	273	2021-02-10	female
20-24	466	54	2	522	2021-02-10	female
25-29	680	99	8	787	2021-02-10	female
30-34	875	116	7	998	2021-02-10	female
35-39	751	128	16	895	2021-02-10	female
40-44	666	125	24	815	2021-02-10	female
45-49	846	154	47	1047	2021-02-10	female
50-54	1181	209	77	1467	2021-02-10	female
55-59	1315	263	127	1705	2021-02-10	female
60-64	1186	312	187	1685	2021-02-10	female
65-69	1183	371	262	1816	2021-02-10	female
70-74	1429	554	518	2501	2021-02-10	female
75-79	1515	643	635	2793	2021-02-10	female
80-84	1583	920	818	3321	2021-02-10	female
85-89	1476	896	866	3238	2021-02-10	female
90+	1133	815	872	2820	2021-02-10	female
0-4	278	29	3	310	2021-02-10	male
5-9	54	9	0	63	2021-02-10	male
10-14	106	17	0	123	2021-02-10	male
15-19	134	25	0	159	2021-02-10	male
20-24	182	49	3	234	2021-02-10	male
25-29	263	83	5	351	2021-02-10	male
30-34	504	81	6	591	2021-02-10	male
35-39	630	115	15	760	2021-02-10	male
40-44	828	153	35	1016	2021-02-10	male
45-49	1198	266	72	1536	2021-02-10	male
50-54	1593	327	109	2029	2021-02-10	male
55-59	1769	432	212	2413	2021-02-10	male
60-64	1791	459	367	2617	2021-02-10	male
65-69	1615	572	486	2673	2021-02-10	male
70-74	1958	738	862	3558	2021-02-10	male
75-79	1855	844	1073	3772	2021-02-10	male
80-84	1673	875	1256	3804	2021-02-10	male
85-89	1158	811	1185	3154	2021-02-10	male
90+	616	496	868	1980	2021-02-10	male
0-4	481	39	3	523	2021-02-10	all
5-9	109	19	0	128	2021-02-10	all
10-14	202	35	0	237	2021-02-10	all
15-19	373	56	3	432	2021-02-10	all
20-24	648	103	5	756	2021-02-10	all
25-29	943	182	13	1138	2021-02-10	all
30-34	1379	197	13	1589	2021-02-10	all
35-39	1381	243	31	1655	2021-02-10	all
40-44	1494	278	59	1831	2021-02-10	all
45-49	2044	420	119	2583	2021-02-10	all
50-54	2774	536	186	3496	2021-02-10	all
55-59	3084	695	339	4118	2021-02-10	all
60-64	2977	771	554	4302	2021-02-10	all
65-69	2798	943	748	4489	2021-02-10	all
70-74	3387	1292	1380	6059	2021-02-10	all
75-79	3370	1487	1708	6565	2021-02-10	all
80-84	3256	1795	2074	7125	2021-02-10	all
85-89	2634	1707	2051	6392	2021-02-10	all
90+	1749	1311	1740	4800	2021-02-10	all
0-4	206	10	0	216	2021-02-11	female
5-9	57	10	0	67	2021-02-11	female
10-14	99	18	0	117	2021-02-11	female
15-19	242	31	3	276	2021-02-11	female
20-24	469	55	2	526	2021-02-11	female
25-29	690	100	8	798	2021-02-11	female
30-34	886	117	7	1010	2021-02-11	female
35-39	765	130	16	911	2021-02-11	female
40-44	681	125	25	831	2021-02-11	female
45-49	865	158	48	1071	2021-02-11	female
50-54	1206	210	79	1495	2021-02-11	female
55-59	1339	270	130	1739	2021-02-11	female
60-64	1209	317	192	1718	2021-02-11	female
65-69	1200	383	273	1856	2021-02-11	female
70-74	1455	560	524	2539	2021-02-11	female
75-79	1534	654	647	2835	2021-02-11	female
80-84	1618	935	828	3381	2021-02-11	female
85-89	1505	916	882	3303	2021-02-11	female
90+	1156	823	885	2864	2021-02-11	female
0-4	281	29	3	313	2021-02-11	male
5-9	54	9	0	63	2021-02-11	male
10-14	108	19	0	127	2021-02-11	male
15-19	135	26	0	161	2021-02-11	male
20-24	188	51	3	242	2021-02-11	male
25-29	270	83	5	358	2021-02-11	male
30-34	509	83	6	598	2021-02-11	male
35-39	643	120	16	779	2021-02-11	male
40-44	846	155	36	1037	2021-02-11	male
45-49	1211	273	72	1556	2021-02-11	male
50-54	1622	335	110	2067	2021-02-11	male
55-59	1807	439	212	2458	2021-02-11	male
60-64	1815	470	373	2658	2021-02-11	male
65-69	1637	577	496	2710	2021-02-11	male
70-74	1993	750	880	3623	2021-02-11	male
75-79	1878	863	1091	3832	2021-02-11	male
80-84	1692	882	1285	3859	2021-02-11	male
85-89	1181	822	1211	3214	2021-02-11	male
90+	631	501	883	2015	2021-02-11	male
0-4	487	39	3	529	2021-02-11	all
5-9	111	19	0	130	2021-02-11	all
10-14	207	37	0	244	2021-02-11	all
15-19	377	57	3	437	2021-02-11	all
20-24	657	106	5	768	2021-02-11	all
25-29	960	183	13	1156	2021-02-11	all
30-34	1395	200	13	1608	2021-02-11	all
35-39	1408	250	32	1690	2021-02-11	all
40-44	1527	280	61	1868	2021-02-11	all
45-49	2076	431	120	2627	2021-02-11	all
50-54	2828	545	189	3562	2021-02-11	all
55-59	3146	709	342	4197	2021-02-11	all
60-64	3024	787	565	4376	2021-02-11	all
65-69	2837	960	769	4566	2021-02-11	all
70-74	3448	1310	1404	6162	2021-02-11	all
75-79	3412	1517	1738	6667	2021-02-11	all
80-84	3310	1817	2113	7240	2021-02-11	all
85-89	2686	1738	2093	6517	2021-02-11	all
90+	1787	1324	1768	4879	2021-02-11	all
0-4	206	10	0	216	2021-02-12	female
5-9	57	10	0	67	2021-02-12	female
10-14	100	18	0	118	2021-02-12	female
15-19	243	31	3	277	2021-02-12	female
20-24	475	56	2	533	2021-02-12	female
25-29	697	101	8	806	2021-02-12	female
30-34	891	118	7	1016	2021-02-12	female
35-39	775	131	16	922	2021-02-12	female
40-44	695	125	25	845	2021-02-12	female
45-49	884	159	49	1092	2021-02-12	female
50-54	1225	211	80	1516	2021-02-12	female
55-59	1374	274	133	1781	2021-02-12	female
60-64	1226	322	195	1743	2021-02-12	female
65-69	1217	386	278	1881	2021-02-12	female
70-74	1480	566	533	2579	2021-02-12	female
75-79	1559	665	658	2882	2021-02-12	female
80-84	1641	949	839	3429	2021-02-12	female
85-89	1532	927	898	3357	2021-02-12	female
90+	1173	835	902	2910	2021-02-12	female
0-4	283	31	3	317	2021-02-12	male
5-9	56	9	0	65	2021-02-12	male
10-14	110	19	0	129	2021-02-12	male
15-19	138	27	0	165	2021-02-12	male
20-24	192	51	3	246	2021-02-12	male
25-29	272	87	6	365	2021-02-12	male
30-34	523	85	6	614	2021-02-12	male
35-39	654	121	16	791	2021-02-12	male
40-44	863	159	37	1059	2021-02-12	male
45-49	1230	274	74	1578	2021-02-12	male
50-54	1649	341	115	2105	2021-02-12	male
55-59	1834	443	218	2495	2021-02-12	male
60-64	1858	480	384	2722	2021-02-12	male
65-69	1660	585	506	2751	2021-02-12	male
70-74	2030	764	898	3692	2021-02-12	male
75-79	1905	880	1120	3905	2021-02-12	male
80-84	1712	891	1308	3911	2021-02-12	male
85-89	1202	833	1226	3261	2021-02-12	male
90+	643	509	902	2054	2021-02-12	male
0-4	489	41	3	533	2021-02-12	all
5-9	113	19	0	132	2021-02-12	all
10-14	210	37	0	247	2021-02-12	all
15-19	381	58	3	442	2021-02-12	all
20-24	667	107	5	779	2021-02-12	all
25-29	969	188	14	1171	2021-02-12	all
30-34	1414	203	13	1630	2021-02-12	all
35-39	1429	252	32	1713	2021-02-12	all
40-44	1558	284	62	1904	2021-02-12	all
45-49	2114	433	123	2670	2021-02-12	all
50-54	2874	552	195	3621	2021-02-12	all
55-59	3208	717	351	4276	2021-02-12	all
60-64	3084	802	579	4465	2021-02-12	all
65-69	2877	971	784	4632	2021-02-12	all
70-74	3510	1330	1431	6271	2021-02-12	all
75-79	3464	1545	1778	6787	2021-02-12	all
80-84	3353	1840	2147	7340	2021-02-12	all
85-89	2734	1760	2124	6618	2021-02-12	all
90+	1816	1344	1804	4964	2021-02-12	all
0-4	208	11	0	219	2021-02-13	female
5-9	57	10	0	67	2021-02-13	female
10-14	102	18	0	120	2021-02-13	female
15-19	246	31	3	280	2021-02-13	female
20-24	481	57	2	540	2021-02-13	female
25-29	701	104	8	813	2021-02-13	female
30-34	902	118	8	1028	2021-02-13	female
35-39	779	131	16	926	2021-02-13	female
40-44	703	128	25	856	2021-02-13	female
45-49	893	160	50	1103	2021-02-13	female
50-54	1250	215	81	1546	2021-02-13	female
55-59	1406	277	134	1817	2021-02-13	female
60-64	1247	324	199	1770	2021-02-13	female
65-69	1236	391	284	1911	2021-02-13	female
70-74	1504	568	545	2617	2021-02-13	female
75-79	1590	670	669	2929	2021-02-13	female
80-84	1662	972	858	3492	2021-02-13	female
85-89	1552	940	916	3408	2021-02-13	female
90+	1191	852	925	2968	2021-02-13	female
0-4	286	31	3	320	2021-02-13	male
5-9	57	9	0	66	2021-02-13	male
10-14	113	20	0	133	2021-02-13	male
15-19	140	27	0	167	2021-02-13	male
20-24	195	52	3	250	2021-02-13	male
25-29	278	88	6	372	2021-02-13	male
30-34	528	87	6	621	2021-02-13	male
35-39	660	122	17	799	2021-02-13	male
40-44	878	165	37	1080	2021-02-13	male
45-49	1244	275	75	1594	2021-02-13	male
50-54	1674	343	120	2137	2021-02-13	male
55-59	1859	450	220	2529	2021-02-13	male
60-64	1884	485	389	2758	2021-02-13	male
65-69	1692	587	517	2796	2021-02-13	male
70-74	2066	778	917	3761	2021-02-13	male
75-79	1930	899	1136	3965	2021-02-13	male
80-84	1730	903	1336	3969	2021-02-13	male
85-89	1217	849	1249	3315	2021-02-13	male
90+	662	521	923	2106	2021-02-13	male
0-4	494	42	3	539	2021-02-13	all
5-9	114	19	0	133	2021-02-13	all
10-14	215	38	0	253	2021-02-13	all
15-19	386	58	3	447	2021-02-13	all
20-24	676	109	5	790	2021-02-13	all
25-29	979	192	14	1185	2021-02-13	all
30-34	1430	205	14	1649	2021-02-13	all
35-39	1439	253	33	1725	2021-02-13	all
40-44	1581	293	62	1936	2021-02-13	all
45-49	2137	435	125	2697	2021-02-13	all
50-54	2924	558	201	3683	2021-02-13	all
55-59	3265	727	354	4346	2021-02-13	all
60-64	3131	809	588	4528	2021-02-13	all
65-69	2928	978	801	4707	2021-02-13	all
70-74	3570	1346	1462	6378	2021-02-13	all
75-79	3520	1569	1805	6894	2021-02-13	all
80-84	3392	1875	2194	7461	2021-02-13	all
85-89	2769	1789	2165	6723	2021-02-13	all
90+	1853	1373	1848	5074	2021-02-13	all
0-4	209	11	0	220	2021-02-14	female
5-9	57	10	0	67	2021-02-14	female
10-14	102	18	0	120	2021-02-14	female
15-19	247	31	3	281	2021-02-14	female
20-24	482	57	2	541	2021-02-14	female
25-29	704	104	8	816	2021-02-14	female
30-34	902	118	8	1028	2021-02-14	female
35-39	781	131	16	928	2021-02-14	female
40-44	704	128	25	857	2021-02-14	female
45-49	895	160	50	1105	2021-02-14	female
50-54	1255	216	81	1552	2021-02-14	female
55-59	1412	277	134	1823	2021-02-14	female
60-64	1248	325	199	1772	2021-02-14	female
65-69	1240	391	284	1915	2021-02-14	female
70-74	1507	568	546	2621	2021-02-14	female
75-79	1593	670	671	2934	2021-02-14	female
80-84	1670	971	859	3500	2021-02-14	female
85-89	1556	942	918	3416	2021-02-14	female
90+	1194	853	925	2972	2021-02-14	female
0-4	292	31	3	326	2021-02-14	male
5-9	59	10	0	69	2021-02-14	male
10-14	113	20	0	133	2021-02-14	male
15-19	141	27	0	168	2021-02-14	male
20-24	197	52	3	252	2021-02-14	male
25-29	280	88	6	374	2021-02-14	male
30-34	529	87	6	622	2021-02-14	male
35-39	662	123	17	802	2021-02-14	male
40-44	880	166	37	1083	2021-02-14	male
45-49	1245	276	75	1596	2021-02-14	male
50-54	1679	343	121	2143	2021-02-14	male
55-59	1868	453	221	2542	2021-02-14	male
60-64	1888	486	391	2765	2021-02-14	male
65-69	1696	588	517	2801	2021-02-14	male
70-74	2072	779	918	3769	2021-02-14	male
75-79	1932	900	1140	3972	2021-02-14	male
80-84	1733	903	1339	3975	2021-02-14	male
85-89	1221	851	1252	3324	2021-02-14	male
90+	662	521	927	2110	2021-02-14	male
0-4	501	42	3	546	2021-02-14	all
5-9	116	20	0	136	2021-02-14	all
10-14	215	38	0	253	2021-02-14	all
15-19	388	58	3	449	2021-02-14	all
20-24	679	109	5	793	2021-02-14	all
25-29	984	192	14	1190	2021-02-14	all
30-34	1431	205	14	1650	2021-02-14	all
35-39	1443	254	33	1730	2021-02-14	all
40-44	1584	294	62	1940	2021-02-14	all
45-49	2140	436	125	2701	2021-02-14	all
50-54	2934	559	202	3695	2021-02-14	all
55-59	3280	730	355	4365	2021-02-14	all
60-64	3136	811	590	4537	2021-02-14	all
65-69	2936	979	801	4716	2021-02-14	all
70-74	3579	1347	1464	6390	2021-02-14	all
75-79	3525	1570	1811	6906	2021-02-14	all
80-84	3403	1874	2198	7475	2021-02-14	all
85-89	2777	1793	2170	6740	2021-02-14	all
90+	1856	1374	1852	5082	2021-02-14	all
0-4	211	11	0	222	2021-02-15	female
5-9	57	10	0	67	2021-02-15	female
10-14	102	18	0	120	2021-02-15	female
15-19	247	32	3	282	2021-02-15	female
20-24	483	57	2	542	2021-02-15	female
25-29	705	104	8	817	2021-02-15	female
30-34	902	119	8	1029	2021-02-15	female
35-39	784	131	16	931	2021-02-15	female
40-44	706	128	25	859	2021-02-15	female
45-49	899	160	50	1109	2021-02-15	female
50-54	1258	216	82	1556	2021-02-15	female
55-59	1415	277	134	1826	2021-02-15	female
60-64	1251	326	199	1776	2021-02-15	female
65-69	1241	391	285	1917	2021-02-15	female
70-74	1508	569	548	2625	2021-02-15	female
75-79	1596	670	671	2937	2021-02-15	female
80-84	1672	973	863	3508	2021-02-15	female
85-89	1559	942	920	3421	2021-02-15	female
90+	1197	855	927	2979	2021-02-15	female
0-4	292	31	3	326	2021-02-15	male
5-9	59	10	0	69	2021-02-15	male
10-14	113	20	0	133	2021-02-15	male
15-19	141	27	0	168	2021-02-15	male
20-24	197	52	3	252	2021-02-15	male
25-29	281	88	6	375	2021-02-15	male
30-34	529	87	6	622	2021-02-15	male
35-39	664	123	17	804	2021-02-15	male
40-44	881	167	37	1085	2021-02-15	male
45-49	1249	277	75	1601	2021-02-15	male
50-54	1679	343	121	2143	2021-02-15	male
55-59	1875	454	224	2553	2021-02-15	male
60-64	1891	487	392	2770	2021-02-15	male
65-69	1699	588	519	2806	2021-02-15	male
70-74	2079	782	920	3781	2021-02-15	male
75-79	1939	901	1141	3981	2021-02-15	male
80-84	1736	905	1342	3983	2021-02-15	male
85-89	1222	851	1253	3326	2021-02-15	male
90+	665	521	927	2113	2021-02-15	male
0-4	503	42	3	548	2021-02-15	all
5-9	116	20	0	136	2021-02-15	all
10-14	215	38	0	253	2021-02-15	all
15-19	388	59	3	450	2021-02-15	all
20-24	680	109	5	794	2021-02-15	all
25-29	986	192	14	1192	2021-02-15	all
30-34	1431	206	14	1651	2021-02-15	all
35-39	1448	254	33	1735	2021-02-15	all
40-44	1587	295	62	1944	2021-02-15	all
45-49	2148	437	125	2710	2021-02-15	all
50-54	2937	559	203	3699	2021-02-15	all
55-59	3290	731	358	4379	2021-02-15	all
60-64	3142	813	591	4546	2021-02-15	all
65-69	2940	979	804	4723	2021-02-15	all
70-74	3587	1351	1468	6406	2021-02-15	all
75-79	3535	1571	1812	6918	2021-02-15	all
80-84	3408	1878	2205	7491	2021-02-15	all
85-89	2781	1793	2173	6747	2021-02-15	all
90+	1862	1376	1854	5092	2021-02-15	all
0-4	213	13	0	226	2021-02-16	female
5-9	59	11	0	70	2021-02-16	female
10-14	103	19	0	122	2021-02-16	female
15-19	250	32	3	285	2021-02-16	female
20-24	490	61	2	553	2021-02-16	female
25-29	712	104	8	824	2021-02-16	female
30-34	911	127	8	1046	2021-02-16	female
35-39	794	137	16	947	2021-02-16	female
40-44	717	132	25	874	2021-02-16	female
45-49	909	163	52	1124	2021-02-16	female
50-54	1279	219	85	1583	2021-02-16	female
55-59	1437	280	138	1855	2021-02-16	female
60-64	1278	330	205	1813	2021-02-16	female
65-69	1263	398	290	1951	2021-02-16	female
70-74	1525	573	557	2655	2021-02-16	female
75-79	1620	682	679	2981	2021-02-16	female
80-84	1692	987	882	3561	2021-02-16	female
85-89	1586	962	931	3479	2021-02-16	female
90+	1211	865	943	3019	2021-02-16	female
0-4	293	31	3	327	2021-02-16	male
5-9	59	10	0	69	2021-02-16	male
10-14	114	20	0	134	2021-02-16	male
15-19	142	28	0	170	2021-02-16	male
20-24	203	50	3	256	2021-02-16	male
25-29	284	88	6	378	2021-02-16	male
30-34	538	87	7	632	2021-02-16	male
35-39	673	128	17	818	2021-02-16	male
40-44	890	170	37	1097	2021-02-16	male
45-49	1269	279	78	1626	2021-02-16	male
50-54	1703	345	122	2170	2021-02-16	male
55-59	1906	464	231	2601	2021-02-16	male
60-64	1915	499	399	2813	2021-02-16	male
65-69	1719	602	531	2852	2021-02-16	male
70-74	2103	793	934	3830	2021-02-16	male
75-79	1971	914	1160	4045	2021-02-16	male
80-84	1756	926	1360	4042	2021-02-16	male
85-89	1247	858	1269	3374	2021-02-16	male
90+	677	525	941	2143	2021-02-16	male
0-4	506	44	3	553	2021-02-16	all
5-9	118	21	0	139	2021-02-16	all
10-14	217	39	0	256	2021-02-16	all
15-19	392	60	3	455	2021-02-16	all
20-24	693	111	5	809	2021-02-16	all
25-29	996	192	14	1202	2021-02-16	all
30-34	1449	214	15	1678	2021-02-16	all
35-39	1467	265	33	1765	2021-02-16	all
40-44	1607	302	62	1971	2021-02-16	all
45-49	2178	442	130	2750	2021-02-16	all
50-54	2982	564	207	3753	2021-02-16	all
55-59	3343	744	369	4456	2021-02-16	all
60-64	3193	829	604	4626	2021-02-16	all
65-69	2982	1000	821	4803	2021-02-16	all
70-74	3628	1366	1491	6485	2021-02-16	all
75-79	3591	1596	1839	7026	2021-02-16	all
80-84	3448	1913	2242	7603	2021-02-16	all
85-89	2833	1820	2200	6853	2021-02-16	all
90+	1888	1390	1884	5162	2021-02-16	all
0-4	214	13	0	227	2021-02-17	female
5-9	59	11	0	70	2021-02-17	female
10-14	104	19	0	123	2021-02-17	female
15-19	250	32	3	285	2021-02-17	female
20-24	495	61	2	558	2021-02-17	female
25-29	716	107	8	831	2021-02-17	female
30-34	920	127	8	1055	2021-02-17	female
35-39	805	139	16	960	2021-02-17	female
40-44	725	134	26	885	2021-02-17	female
45-49	920	168	54	1142	2021-02-17	female
50-54	1305	225	85	1615	2021-02-17	female
55-59	1459	285	142	1886	2021-02-17	female
60-64	1298	334	206	1838	2021-02-17	female
65-69	1277	404	297	1978	2021-02-17	female
70-74	1541	586	567	2694	2021-02-17	female
75-79	1646	696	699	3041	2021-02-17	female
80-84	1718	1010	899	3627	2021-02-17	female
85-89	1607	975	951	3533	2021-02-17	female
90+	1227	884	961	3072	2021-02-17	female
0-4	295	31	4	330	2021-02-17	male
5-9	61	10	0	71	2021-02-17	male
10-14	115	21	0	136	2021-02-17	male
15-19	144	28	0	172	2021-02-17	male
20-24	205	52	3	260	2021-02-17	male
25-29	285	89	6	380	2021-02-17	male
30-34	547	89	7	643	2021-02-17	male
35-39	683	131	18	832	2021-02-17	male
40-44	907	176	37	1120	2021-02-17	male
45-49	1298	283	83	1664	2021-02-17	male
50-54	1729	353	124	2206	2021-02-17	male
55-59	1936	476	236	2648	2021-02-17	male
60-64	1964	510	408	2882	2021-02-17	male
65-69	1756	615	540	2911	2021-02-17	male
70-74	2144	813	948	3905	2021-02-17	male
75-79	2001	932	1193	4126	2021-02-17	male
80-84	1781	943	1389	4113	2021-02-17	male
85-89	1259	867	1287	3413	2021-02-17	male
90+	687	537	956	2180	2021-02-17	male
0-4	509	44	4	557	2021-02-17	all
5-9	120	21	0	141	2021-02-17	all
10-14	219	40	0	259	2021-02-17	all
15-19	394	60	3	457	2021-02-17	all
20-24	700	113	5	818	2021-02-17	all
25-29	1001	196	14	1211	2021-02-17	all
30-34	1467	216	15	1698	2021-02-17	all
35-39	1488	270	34	1792	2021-02-17	all
40-44	1632	310	63	2005	2021-02-17	all
45-49	2218	451	137	2806	2021-02-17	all
50-54	3034	578	209	3821	2021-02-17	all
55-59	3395	761	378	4534	2021-02-17	all
60-64	3262	844	614	4720	2021-02-17	all
65-69	3033	1019	837	4889	2021-02-17	all
70-74	3685	1399	1515	6599	2021-02-17	all
75-79	3647	1628	1892	7167	2021-02-17	all
80-84	3499	1953	2288	7740	2021-02-17	all
85-89	2866	1842	2238	6946	2021-02-17	all
90+	1914	1421	1917	5252	2021-02-17	all
0-4	218	14	0	232	2021-02-18	female
5-9	62	12	0	74	2021-02-18	female
10-14	108	20	0	128	2021-02-18	female
15-19	253	32	3	288	2021-02-18	female
20-24	501	61	3	565	2021-02-18	female
25-29	723	108	8	839	2021-02-18	female
30-34	932	127	8	1067	2021-02-18	female
35-39	818	141	16	975	2021-02-18	female
40-44	733	137	27	897	2021-02-18	female
45-49	938	170	56	1164	2021-02-18	female
50-54	1327	227	86	1640	2021-02-18	female
55-59	1489	296	143	1928	2021-02-18	female
60-64	1328	344	210	1882	2021-02-18	female
65-69	1298	408	307	2013	2021-02-18	female
70-74	1568	597	581	2746	2021-02-18	female
75-79	1679	709	713	3101	2021-02-18	female
80-84	1761	1021	915	3697	2021-02-18	female
85-89	1632	999	978	3609	2021-02-18	female
90+	1249	903	979	3131	2021-02-18	female
0-4	296	32	4	332	2021-02-18	male
5-9	63	11	0	74	2021-02-18	male
10-14	116	22	0	138	2021-02-18	male
15-19	149	28	0	177	2021-02-18	male
20-24	206	52	3	261	2021-02-18	male
25-29	290	91	6	387	2021-02-18	male
30-34	556	90	7	653	2021-02-18	male
35-39	700	135	19	854	2021-02-18	male
40-44	928	179	37	1144	2021-02-18	male
45-49	1324	288	84	1696	2021-02-18	male
50-54	1764	365	130	2259	2021-02-18	male
55-59	1959	482	243	2684	2021-02-18	male
60-64	1999	524	419	2942	2021-02-18	male
65-69	1787	623	558	2968	2021-02-18	male
70-74	2188	827	970	3985	2021-02-18	male
75-79	2036	950	1216	4202	2021-02-18	male
80-84	1803	960	1415	4178	2021-02-18	male
85-89	1282	885	1308	3475	2021-02-18	male
90+	702	548	970	2220	2021-02-18	male
0-4	514	46	4	564	2021-02-18	all
5-9	125	23	0	148	2021-02-18	all
10-14	224	42	0	266	2021-02-18	all
15-19	402	60	3	465	2021-02-18	all
20-24	707	113	6	826	2021-02-18	all
25-29	1013	199	14	1226	2021-02-18	all
30-34	1488	217	15	1720	2021-02-18	all
35-39	1518	276	35	1829	2021-02-18	all
40-44	1661	316	64	2041	2021-02-18	all
45-49	2262	458	140	2860	2021-02-18	all
50-54	3091	592	216	3899	2021-02-18	all
55-59	3448	778	386	4612	2021-02-18	all
60-64	3327	868	629	4824	2021-02-18	all
65-69	3085	1031	865	4981	2021-02-18	all
70-74	3756	1424	1551	6731	2021-02-18	all
75-79	3715	1659	1929	7303	2021-02-18	all
80-84	3564	1981	2330	7875	2021-02-18	all
85-89	2914	1884	2286	7084	2021-02-18	all
90+	1951	1451	1949	5351	2021-02-18	all
0-4	222	14	0	236	2021-02-19	female
5-9	62	13	0	75	2021-02-19	female
10-14	112	21	0	133	2021-02-19	female
15-19	257	32	3	292	2021-02-19	female
20-24	508	61	2	571	2021-02-19	female
25-29	729	109	8	846	2021-02-19	female
30-34	945	131	8	1084	2021-02-19	female
35-39	829	142	16	987	2021-02-19	female
40-44	740	140	28	908	2021-02-19	female
45-49	951	173	56	1180	2021-02-19	female
50-54	1356	230	89	1675	2021-02-19	female
55-59	1512	303	144	1959	2021-02-19	female
60-64	1352	347	217	1916	2021-02-19	female
65-69	1314	417	317	2048	2021-02-19	female
70-74	1590	600	590	2780	2021-02-19	female
75-79	1708	725	719	3152	2021-02-19	female
80-84	1787	1032	933	3752	2021-02-19	female
85-89	1651	1012	989	3652	2021-02-19	female
90+	1275	915	1005	3195	2021-02-19	female
0-4	308	33	4	345	2021-02-19	male
5-9	67	12	0	79	2021-02-19	male
10-14	118	22	0	140	2021-02-19	male
15-19	153	30	0	183	2021-02-19	male
20-24	207	52	3	262	2021-02-19	male
25-29	298	92	6	396	2021-02-19	male
30-34	563	90	7	660	2021-02-19	male
35-39	705	137	21	863	2021-02-19	male
40-44	946	183	36	1165	2021-02-19	male
45-49	1343	294	85	1722	2021-02-19	male
50-54	1783	373	131	2287	2021-02-19	male
55-59	1988	491	249	2728	2021-02-19	male
60-64	2031	531	433	2995	2021-02-19	male
65-69	1818	636	579	3033	2021-02-19	male
70-74	2215	835	984	4034	2021-02-19	male
75-79	2071	966	1242	4279	2021-02-19	male
80-84	1822	973	1435	4230	2021-02-19	male
85-89	1302	893	1325	3520	2021-02-19	male
90+	714	556	990	2260	2021-02-19	male
0-4	530	47	4	581	2021-02-19	all
5-9	129	25	0	154	2021-02-19	all
10-14	230	43	0	273	2021-02-19	all
15-19	410	62	3	475	2021-02-19	all
20-24	715	113	5	833	2021-02-19	all
25-29	1027	201	14	1242	2021-02-19	all
30-34	1508	221	15	1744	2021-02-19	all
35-39	1534	279	37	1850	2021-02-19	all
40-44	1686	323	64	2073	2021-02-19	all
45-49	2294	467	141	2902	2021-02-19	all
50-54	3139	603	220	3962	2021-02-19	all
55-59	3500	794	393	4687	2021-02-19	all
60-64	3383	878	650	4911	2021-02-19	all
65-69	3132	1053	896	5081	2021-02-19	all
70-74	3805	1435	1574	6814	2021-02-19	all
75-79	3779	1691	1961	7431	2021-02-19	all
80-84	3609	2005	2368	7982	2021-02-19	all
85-89	2953	1905	2314	7172	2021-02-19	all
90+	1989	1471	1995	5455	2021-02-19	all
0-4	228	14	0	242	2021-02-20	female
5-9	64	13	0	77	2021-02-20	female
10-14	114	21	0	135	2021-02-20	female
15-19	257	33	3	293	2021-02-20	female
20-24	513	61	2	576	2021-02-20	female
25-29	733	109	8	850	2021-02-20	female
30-34	952	133	8	1093	2021-02-20	female
35-39	836	143	16	995	2021-02-20	female
40-44	750	142	28	920	2021-02-20	female
45-49	958	174	57	1189	2021-02-20	female
50-54	1368	234	92	1694	2021-02-20	female
55-59	1527	304	147	1978	2021-02-20	female
60-64	1374	349	220	1943	2021-02-20	female
65-69	1328	423	323	2074	2021-02-20	female
70-74	1610	606	595	2811	2021-02-20	female
75-79	1726	734	728	3188	2021-02-20	female
80-84	1799	1049	946	3794	2021-02-20	female
85-89	1669	1029	1001	3699	2021-02-20	female
90+	1296	927	1023	3246	2021-02-20	female
0-4	314	34	4	352	2021-02-20	male
5-9	68	12	0	80	2021-02-20	male
10-14	120	22	0	142	2021-02-20	male
15-19	153	30	0	183	2021-02-20	male
20-24	208	54	3	265	2021-02-20	male
25-29	299	93	6	398	2021-02-20	male
30-34	565	92	7	664	2021-02-20	male
35-39	717	137	21	875	2021-02-20	male
40-44	955	187	38	1180	2021-02-20	male
45-49	1357	298	85	1740	2021-02-20	male
50-54	1803	380	134	2317	2021-02-20	male
55-59	2022	498	252	2772	2021-02-20	male
60-64	2049	538	437	3024	2021-02-20	male
65-69	1837	641	590	3068	2021-02-20	male
70-74	2239	845	996	4080	2021-02-20	male
75-79	2097	975	1255	4327	2021-02-20	male
80-84	1837	985	1453	4275	2021-02-20	male
85-89	1319	905	1342	3566	2021-02-20	male
90+	720	562	1000	2282	2021-02-20	male
0-4	542	48	4	594	2021-02-20	all
5-9	132	25	0	157	2021-02-20	all
10-14	234	43	0	277	2021-02-20	all
15-19	410	63	3	476	2021-02-20	all
20-24	721	115	5	841	2021-02-20	all
25-29	1032	202	14	1248	2021-02-20	all
30-34	1517	225	15	1757	2021-02-20	all
35-39	1553	280	37	1870	2021-02-20	all
40-44	1705	329	66	2100	2021-02-20	all
45-49	2315	472	142	2929	2021-02-20	all
50-54	3171	614	226	4011	2021-02-20	all
55-59	3549	802	399	4750	2021-02-20	all
60-64	3423	887	657	4967	2021-02-20	all
65-69	3165	1064	913	5142	2021-02-20	all
70-74	3849	1451	1591	6891	2021-02-20	all
75-79	3823	1709	1983	7515	2021-02-20	all
80-84	3636	2034	2399	8069	2021-02-20	all
85-89	2988	1934	2343	7265	2021-02-20	all
90+	2016	1489	2023	5528	2021-02-20	all
0-4	229	14	0	243	2021-02-21	female
5-9	65	13	0	78	2021-02-21	female
10-14	115	21	0	136	2021-02-21	female
15-19	257	33	3	293	2021-02-21	female
20-24	514	61	2	577	2021-02-21	female
25-29	734	109	8	851	2021-02-21	female
30-34	954	133	8	1095	2021-02-21	female
35-39	838	143	16	997	2021-02-21	female
40-44	752	143	28	923	2021-02-21	female
45-49	963	174	57	1194	2021-02-21	female
50-54	1373	235	92	1700	2021-02-21	female
55-59	1528	306	147	1981	2021-02-21	female
60-64	1376	349	221	1946	2021-02-21	female
65-69	1331	423	323	2077	2021-02-21	female
70-74	1612	608	596	2816	2021-02-21	female
75-79	1731	735	729	3195	2021-02-21	female
80-84	1802	1049	949	3800	2021-02-21	female
85-89	1676	1031	1006	3713	2021-02-21	female
90+	1302	928	1025	3255	2021-02-21	female
0-4	314	35	4	353	2021-02-21	male
5-9	68	12	0	80	2021-02-21	male
10-14	120	22	0	142	2021-02-21	male
15-19	155	30	0	185	2021-02-21	male
20-24	210	54	3	267	2021-02-21	male
25-29	302	93	6	401	2021-02-21	male
30-34	567	93	7	667	2021-02-21	male
35-39	719	137	21	877	2021-02-21	male
40-44	961	187	38	1186	2021-02-21	male
45-49	1363	298	85	1746	2021-02-21	male
50-54	1811	382	134	2327	2021-02-21	male
55-59	2032	503	252	2787	2021-02-21	male
60-64	2055	540	437	3032	2021-02-21	male
65-69	1842	641	590	3073	2021-02-21	male
70-74	2247	848	1000	4095	2021-02-21	male
75-79	2104	981	1255	4340	2021-02-21	male
80-84	1840	987	1456	4283	2021-02-21	male
85-89	1326	907	1346	3579	2021-02-21	male
90+	721	563	1005	2289	2021-02-21	male
0-4	543	49	4	596	2021-02-21	all
5-9	133	25	0	158	2021-02-21	all
10-14	235	43	0	278	2021-02-21	all
15-19	412	63	3	478	2021-02-21	all
20-24	724	115	5	844	2021-02-21	all
25-29	1036	202	14	1252	2021-02-21	all
30-34	1521	226	15	1762	2021-02-21	all
35-39	1557	280	37	1874	2021-02-21	all
40-44	1713	330	66	2109	2021-02-21	all
45-49	2326	472	142	2940	2021-02-21	all
50-54	3184	617	226	4027	2021-02-21	all
55-59	3560	809	399	4768	2021-02-21	all
60-64	3431	889	658	4978	2021-02-21	all
65-69	3173	1064	913	5150	2021-02-21	all
70-74	3859	1456	1596	6911	2021-02-21	all
75-79	3835	1716	1984	7535	2021-02-21	all
80-84	3642	2036	2405	8083	2021-02-21	all
85-89	3002	1938	2352	7292	2021-02-21	all
90+	2023	1491	2030	5544	2021-02-21	all
0-4	232	14	0	246	2021-02-22	female
5-9	65	13	0	78	2021-02-22	female
10-14	115	21	0	136	2021-02-22	female
15-19	257	33	3	293	2021-02-22	female
20-24	515	61	2	578	2021-02-22	female
25-29	736	109	8	853	2021-02-22	female
30-34	954	133	8	1095	2021-02-22	female
35-39	838	143	16	997	2021-02-22	female
40-44	756	143	28	927	2021-02-22	female
45-49	966	174	57	1197	2021-02-22	female
50-54	1373	235	92	1700	2021-02-22	female
55-59	1530	306	148	1984	2021-02-22	female
60-64	1377	349	222	1948	2021-02-22	female
65-69	1334	423	323	2080	2021-02-22	female
70-74	1615	608	596	2819	2021-02-22	female
75-79	1733	735	732	3200	2021-02-22	female
80-84	1803	1050	951	3804	2021-02-22	female
85-89	1676	1033	1006	3715	2021-02-22	female
90+	1304	929	1027	3260	2021-02-22	female
0-4	315	35	4	354	2021-02-22	male
5-9	68	12	0	80	2021-02-22	male
10-14	120	22	0	142	2021-02-22	male
15-19	155	30	0	185	2021-02-22	male
20-24	211	54	3	268	2021-02-22	male
25-29	302	93	6	401	2021-02-22	male
30-34	568	94	7	669	2021-02-22	male
35-39	719	137	21	877	2021-02-22	male
40-44	962	187	38	1187	2021-02-22	male
45-49	1365	298	85	1748	2021-02-22	male
50-54	1815	382	135	2332	2021-02-22	male
55-59	2033	503	254	2790	2021-02-22	male
60-64	2058	540	437	3035	2021-02-22	male
65-69	1842	641	590	3073	2021-02-22	male
70-74	2251	848	1002	4101	2021-02-22	male
75-79	2106	981	1255	4342	2021-02-22	male
80-84	1841	987	1458	4286	2021-02-22	male
85-89	1328	908	1346	3582	2021-02-22	male
90+	724	563	1006	2293	2021-02-22	male
0-4	547	49	4	600	2021-02-22	all
5-9	133	25	0	158	2021-02-22	all
10-14	235	43	0	278	2021-02-22	all
15-19	412	63	3	478	2021-02-22	all
20-24	726	115	5	846	2021-02-22	all
25-29	1038	202	14	1254	2021-02-22	all
30-34	1522	227	15	1764	2021-02-22	all
35-39	1557	280	37	1874	2021-02-22	all
40-44	1718	330	66	2114	2021-02-22	all
45-49	2331	472	142	2945	2021-02-22	all
50-54	3188	617	227	4032	2021-02-22	all
55-59	3563	809	402	4774	2021-02-22	all
60-64	3435	889	659	4983	2021-02-22	all
65-69	3176	1064	913	5153	2021-02-22	all
70-74	3866	1456	1598	6920	2021-02-22	all
75-79	3839	1716	1987	7542	2021-02-22	all
80-84	3644	2037	2409	8090	2021-02-22	all
85-89	3004	1941	2352	7297	2021-02-22	all
90+	2028	1492	2033	5553	2021-02-22	all
0-4	232	14	0	246	2021-02-23	female
5-9	67	13	0	80	2021-02-23	female
10-14	116	22	0	138	2021-02-23	female
15-19	262	35	3	300	2021-02-23	female
20-24	522	64	3	589	2021-02-23	female
25-29	741	112	8	861	2021-02-23	female
30-34	962	135	8	1105	2021-02-23	female
35-39	844	146	16	1006	2021-02-23	female
40-44	765	146	28	939	2021-02-23	female
45-49	983	177	57	1217	2021-02-23	female
50-54	1394	241	94	1729	2021-02-23	female
55-59	1551	311	154	2016	2021-02-23	female
60-64	1393	355	225	1973	2021-02-23	female
65-69	1350	430	328	2108	2021-02-23	female
70-74	1632	618	603	2853	2021-02-23	female
75-79	1750	746	740	3236	2021-02-23	female
80-84	1825	1060	960	3845	2021-02-23	female
85-89	1699	1054	1014	3767	2021-02-23	female
90+	1323	947	1043	3313	2021-02-23	female
0-4	322	36	4	362	2021-02-23	male
5-9	69	12	0	81	2021-02-23	male
10-14	120	23	0	143	2021-02-23	male
15-19	156	32	0	188	2021-02-23	male
20-24	214	55	4	273	2021-02-23	male
25-29	307	93	6	406	2021-02-23	male
30-34	571	98	8	677	2021-02-23	male
35-39	729	139	21	889	2021-02-23	male
40-44	972	189	38	1199	2021-02-23	male
45-49	1372	300	87	1759	2021-02-23	male
50-54	1832	389	140	2361	2021-02-23	male
55-59	2061	515	258	2834	2021-02-23	male
60-64	2091	556	452	3099	2021-02-23	male
65-69	1860	655	598	3113	2021-02-23	male
70-74	2283	864	1016	4163	2021-02-23	male
75-79	2123	990	1270	4383	2021-02-23	male
80-84	1857	997	1474	4328	2021-02-23	male
85-89	1350	921	1358	3629	2021-02-23	male
90+	733	572	1017	2322	2021-02-23	male
0-4	554	50	4	608	2021-02-23	all
5-9	136	25	0	161	2021-02-23	all
10-14	236	45	0	281	2021-02-23	all
15-19	418	67	3	488	2021-02-23	all
20-24	736	119	7	862	2021-02-23	all
25-29	1048	205	14	1267	2021-02-23	all
30-34	1533	233	16	1782	2021-02-23	all
35-39	1573	285	37	1895	2021-02-23	all
40-44	1737	335	66	2138	2021-02-23	all
45-49	2355	477	144	2976	2021-02-23	all
50-54	3226	630	234	4090	2021-02-23	all
55-59	3612	826	412	4850	2021-02-23	all
60-64	3484	911	677	5072	2021-02-23	all
65-69	3210	1085	926	5221	2021-02-23	all
70-74	3915	1482	1619	7016	2021-02-23	all
75-79	3873	1736	2010	7619	2021-02-23	all
80-84	3682	2057	2434	8173	2021-02-23	all
85-89	3049	1975	2372	7396	2021-02-23	all
90+	2056	1519	2060	5635	2021-02-23	all
0-4	236	15	0	251	2021-02-24	female
5-9	68	13	0	81	2021-02-24	female
10-14	117	21	0	138	2021-02-24	female
15-19	262	35	3	300	2021-02-24	female
20-24	527	64	3	594	2021-02-24	female
25-29	747	112	8	867	2021-02-24	female
30-34	967	138	8	1113	2021-02-24	female
35-39	858	146	18	1022	2021-02-24	female
40-44	774	148	28	950	2021-02-24	female
45-49	991	181	63	1235	2021-02-24	female
50-54	1414	244	96	1754	2021-02-24	female
55-59	1576	314	155	2045	2021-02-24	female
60-64	1423	361	231	2015	2021-02-24	female
65-69	1367	438	337	2142	2021-02-24	female
70-74	1662	631	615	2908	2021-02-24	female
75-79	1786	757	755	3298	2021-02-24	female
80-84	1842	1074	970	3886	2021-02-24	female
85-89	1733	1074	1029	3836	2021-02-24	female
90+	1342	958	1058	3358	2021-02-24	female
0-4	324	37	4	365	2021-02-24	male
5-9	71	11	0	82	2021-02-24	male
10-14	122	23	0	145	2021-02-24	male
15-19	158	34	0	192	2021-02-24	male
20-24	216	55	4	275	2021-02-24	male
25-29	310	98	7	415	2021-02-24	male
30-34	582	99	9	690	2021-02-24	male
35-39	743	142	21	906	2021-02-24	male
40-44	986	193	38	1217	2021-02-24	male
45-49	1398	307	88	1793	2021-02-24	male
50-54	1858	396	148	2402	2021-02-24	male
55-59	2100	527	265	2892	2021-02-24	male
60-64	2129	570	456	3155	2021-02-24	male
65-69	1884	660	612	3156	2021-02-24	male
70-74	2306	875	1034	4215	2021-02-24	male
75-79	2139	1009	1289	4437	2021-02-24	male
80-84	1887	1009	1499	4395	2021-02-24	male
85-89	1368	935	1380	3683	2021-02-24	male
90+	739	581	1032	2352	2021-02-24	male
0-4	560	52	4	616	2021-02-24	all
5-9	139	24	0	163	2021-02-24	all
10-14	239	44	0	283	2021-02-24	all
15-19	420	69	3	492	2021-02-24	all
20-24	743	119	7	869	2021-02-24	all
25-29	1057	210	15	1282	2021-02-24	all
30-34	1549	237	17	1803	2021-02-24	all
35-39	1601	288	39	1928	2021-02-24	all
40-44	1760	341	66	2167	2021-02-24	all
45-49	2389	488	151	3028	2021-02-24	all
50-54	3272	640	244	4156	2021-02-24	all
55-59	3676	841	420	4937	2021-02-24	all
60-64	3552	931	687	5170	2021-02-24	all
65-69	3251	1098	949	5298	2021-02-24	all
70-74	3968	1506	1649	7123	2021-02-24	all
75-79	3925	1766	2044	7735	2021-02-24	all
80-84	3729	2083	2469	8281	2021-02-24	all
85-89	3101	2009	2409	7519	2021-02-24	all
90+	2081	1539	2090	5710	2021-02-24	all
0-4	238	16	1	255	2021-02-25	female
5-9	68	14	0	82	2021-02-25	female
10-14	119	21	0	140	2021-02-25	female
15-19	263	37	3	303	2021-02-25	female
20-24	532	65	3	600	2021-02-25	female
25-29	755	113	8	876	2021-02-25	female
30-34	977	139	8	1124	2021-02-25	female
35-39	871	148	19	1038	2021-02-25	female
40-44	784	151	29	964	2021-02-25	female
45-49	1004	183	63	1250	2021-02-25	female
50-54	1435	249	97	1781	2021-02-25	female
55-59	1596	321	157	2074	2021-02-25	female
60-64	1444	362	231	2037	2021-02-25	female
65-69	1379	446	339	2164	2021-02-25	female
70-74	1676	648	625	2949	2021-02-25	female
75-79	1815	771	765	3351	2021-02-25	female
80-84	1865	1089	983	3937	2021-02-25	female
85-89	1756	1096	1042	3894	2021-02-25	female
90+	1364	971	1073	3408	2021-02-25	female
0-4	326	37	4	367	2021-02-25	male
5-9	72	10	0	82	2021-02-25	male
10-14	122	24	0	146	2021-02-25	male
15-19	159	34	0	193	2021-02-25	male
20-24	221	55	4	280	2021-02-25	male
25-29	311	98	7	416	2021-02-25	male
30-34	590	100	9	699	2021-02-25	male
35-39	753	146	21	920	2021-02-25	male
40-44	1001	198	39	1238	2021-02-25	male
45-49	1418	314	89	1821	2021-02-25	male
50-54	1884	403	153	2440	2021-02-25	male
55-59	2133	540	268	2941	2021-02-25	male
60-64	2151	576	465	3192	2021-02-25	male
65-69	1906	673	623	3202	2021-02-25	male
70-74	2321	890	1052	4263	2021-02-25	male
75-79	2159	1025	1313	4497	2021-02-25	male
80-84	1902	1020	1513	4435	2021-02-25	male
85-89	1387	947	1394	3728	2021-02-25	male
90+	748	588	1047	2383	2021-02-25	male
0-4	564	53	5	622	2021-02-25	all
5-9	140	24	0	164	2021-02-25	all
10-14	241	45	0	286	2021-02-25	all
15-19	422	71	3	496	2021-02-25	all
20-24	753	120	7	880	2021-02-25	all
25-29	1066	211	15	1292	2021-02-25	all
30-34	1567	239	17	1823	2021-02-25	all
35-39	1624	294	40	1958	2021-02-25	all
40-44	1785	349	68	2202	2021-02-25	all
45-49	2422	497	152	3071	2021-02-25	all
50-54	3319	652	250	4221	2021-02-25	all
55-59	3729	861	425	5015	2021-02-25	all
60-64	3595	938	696	5229	2021-02-25	all
65-69	3285	1119	962	5366	2021-02-25	all
70-74	3997	1538	1677	7212	2021-02-25	all
75-79	3974	1796	2078	7848	2021-02-25	all
80-84	3767	2109	2496	8372	2021-02-25	all
85-89	3143	2043	2436	7622	2021-02-25	all
90+	2112	1559	2120	5791	2021-02-25	all
0-4	241	16	1	258	2021-02-26	female
5-9	69	15	0	84	2021-02-26	female
10-14	119	21	0	140	2021-02-26	female
15-19	265	38	3	306	2021-02-26	female
20-24	539	66	3	608	2021-02-26	female
25-29	758	115	8	881	2021-02-26	female
30-34	983	141	8	1132	2021-02-26	female
35-39	885	151	19	1055	2021-02-26	female
40-44	798	153	29	980	2021-02-26	female
45-49	1015	184	63	1262	2021-02-26	female
50-54	1446	252	97	1795	2021-02-26	female
55-59	1622	327	159	2108	2021-02-26	female
60-64	1474	368	236	2078	2021-02-26	female
65-69	1397	457	346	2200	2021-02-26	female
70-74	1694	657	634	2985	2021-02-26	female
75-79	1841	780	775	3396	2021-02-26	female
80-84	1887	1097	997	3981	2021-02-26	female
85-89	1782	1108	1055	3945	2021-02-26	female
90+	1381	987	1087	3455	2021-02-26	female
0-4	331	37	4	372	2021-02-26	male
5-9	72	10	0	82	2021-02-26	male
10-14	123	24	0	147	2021-02-26	male
15-19	160	34	0	194	2021-02-26	male
20-24	226	55	4	285	2021-02-26	male
25-29	313	98	7	418	2021-02-26	male
30-34	599	100	9	708	2021-02-26	male
35-39	766	150	21	937	2021-02-26	male
40-44	1011	200	41	1252	2021-02-26	male
45-49	1439	320	89	1848	2021-02-26	male
50-54	1907	408	155	2470	2021-02-26	male
55-59	2162	548	278	2988	2021-02-26	male
60-64	2191	586	471	3248	2021-02-26	male
65-69	1939	681	637	3257	2021-02-26	male
70-74	2350	902	1066	4318	2021-02-26	male
75-79	2185	1037	1333	4555	2021-02-26	male
80-84	1930	1039	1529	4498	2021-02-26	male
85-89	1402	953	1407	3762	2021-02-26	male
90+	754	596	1058	2408	2021-02-26	male
0-4	572	53	5	630	2021-02-26	all
5-9	141	25	0	166	2021-02-26	all
10-14	242	45	0	287	2021-02-26	all
15-19	425	72	3	500	2021-02-26	all
20-24	765	121	7	893	2021-02-26	all
25-29	1071	213	15	1299	2021-02-26	all
30-34	1582	241	17	1840	2021-02-26	all
35-39	1651	301	40	1992	2021-02-26	all
40-44	1809	353	70	2232	2021-02-26	all
45-49	2454	504	152	3110	2021-02-26	all
50-54	3353	660	252	4265	2021-02-26	all
55-59	3784	875	437	5096	2021-02-26	all
60-64	3665	954	707	5326	2021-02-26	all
65-69	3336	1138	983	5457	2021-02-26	all
70-74	4044	1559	1700	7303	2021-02-26	all
75-79	4026	1817	2108	7951	2021-02-26	all
80-84	3817	2136	2526	8479	2021-02-26	all
85-89	3184	2061	2462	7707	2021-02-26	all
90+	2135	1583	2145	5863	2021-02-26	all
0-4	243	16	1	260	2021-02-27	female
5-9	70	15	0	85	2021-02-27	female
10-14	121	21	0	142	2021-02-27	female
15-19	267	38	3	308	2021-02-27	female
20-24	544	66	3	613	2021-02-27	female
25-29	762	117	8	887	2021-02-27	female
30-34	990	142	8	1140	2021-02-27	female
35-39	892	151	19	1062	2021-02-27	female
40-44	804	157	29	990	2021-02-27	female
45-49	1027	185	63	1275	2021-02-27	female
50-54	1456	252	98	1806	2021-02-27	female
55-59	1632	328	161	2121	2021-02-27	female
60-64	1485	372	237	2094	2021-02-27	female
65-69	1412	462	353	2227	2021-02-27	female
70-74	1719	664	639	3022	2021-02-27	female
75-79	1858	785	785	3428	2021-02-27	female
80-84	1908	1103	1008	4019	2021-02-27	female
85-89	1798	1121	1067	3986	2021-02-27	female
90+	1387	994	1094	3475	2021-02-27	female
0-4	332	37	4	373	2021-02-27	male
5-9	72	10	0	82	2021-02-27	male
10-14	124	24	0	148	2021-02-27	male
15-19	160	35	0	195	2021-02-27	male
20-24	229	56	4	289	2021-02-27	male
25-29	315	99	7	421	2021-02-27	male
30-34	602	103	9	714	2021-02-27	male
35-39	774	151	21	946	2021-02-27	male
40-44	1024	200	43	1267	2021-02-27	male
45-49	1450	323	90	1863	2021-02-27	male
50-54	1921	411	155	2487	2021-02-27	male
55-59	2185	554	282	3021	2021-02-27	male
60-64	2208	594	479	3281	2021-02-27	male
65-69	1953	684	643	3280	2021-02-27	male
70-74	2371	911	1074	4356	2021-02-27	male
75-79	2204	1049	1349	4602	2021-02-27	male
80-84	1954	1053	1539	4546	2021-02-27	male
85-89	1416	966	1420	3802	2021-02-27	male
90+	760	599	1070	2429	2021-02-27	male
0-4	575	53	5	633	2021-02-27	all
5-9	142	25	0	167	2021-02-27	all
10-14	245	45	0	290	2021-02-27	all
15-19	427	73	3	503	2021-02-27	all
20-24	773	122	7	902	2021-02-27	all
25-29	1077	216	15	1308	2021-02-27	all
30-34	1592	245	17	1854	2021-02-27	all
35-39	1666	302	40	2008	2021-02-27	all
40-44	1828	357	72	2257	2021-02-27	all
45-49	2477	508	153	3138	2021-02-27	all
50-54	3377	663	253	4293	2021-02-27	all
55-59	3817	882	443	5142	2021-02-27	all
60-64	3693	966	716	5375	2021-02-27	all
65-69	3365	1146	996	5507	2021-02-27	all
70-74	4090	1575	1713	7378	2021-02-27	all
75-79	4062	1834	2134	8030	2021-02-27	all
80-84	3862	2156	2547	8565	2021-02-27	all
85-89	3214	2087	2487	7788	2021-02-27	all
90+	2147	1593	2164	5904	2021-02-27	all
0-4	243	16	1	260	2021-02-28	female
5-9	70	16	0	86	2021-02-28	female
10-14	121	21	0	142	2021-02-28	female
15-19	267	38	3	308	2021-02-28	female
20-24	544	66	3	613	2021-02-28	female
25-29	762	117	8	887	2021-02-28	female
30-34	992	142	8	1142	2021-02-28	female
35-39	893	151	19	1063	2021-02-28	female
40-44	806	158	29	993	2021-02-28	female
45-49	1029	185	63	1277	2021-02-28	female
50-54	1460	252	98	1810	2021-02-28	female
55-59	1634	329	161	2124	2021-02-28	female
60-64	1485	372	237	2094	2021-02-28	female
65-69	1415	462	353	2230	2021-02-28	female
70-74	1724	664	639	3027	2021-02-28	female
75-79	1859	785	787	3431	2021-02-28	female
80-84	1911	1105	1008	4024	2021-02-28	female
85-89	1800	1123	1070	3993	2021-02-28	female
90+	1387	996	1094	3477	2021-02-28	female
0-4	332	37	4	373	2021-02-28	male
5-9	72	10	0	82	2021-02-28	male
10-14	124	24	0	148	2021-02-28	male
15-19	160	35	0	195	2021-02-28	male
20-24	229	56	4	289	2021-02-28	male
25-29	317	100	7	424	2021-02-28	male
30-34	603	103	9	715	2021-02-28	male
35-39	775	151	21	947	2021-02-28	male
40-44	1024	200	43	1267	2021-02-28	male
45-49	1452	323	90	1865	2021-02-28	male
50-54	1921	411	155	2487	2021-02-28	male
55-59	2191	557	282	3030	2021-02-28	male
60-64	2209	594	481	3284	2021-02-28	male
65-69	1956	684	644	3284	2021-02-28	male
70-74	2377	912	1075	4364	2021-02-28	male
75-79	2208	1050	1350	4608	2021-02-28	male
80-84	1954	1053	1542	4549	2021-02-28	male
85-89	1419	966	1422	3807	2021-02-28	male
90+	762	600	1071	2433	2021-02-28	male
0-4	575	53	5	633	2021-02-28	all
5-9	142	26	0	168	2021-02-28	all
10-14	245	45	0	290	2021-02-28	all
15-19	427	73	3	503	2021-02-28	all
20-24	773	122	7	902	2021-02-28	all
25-29	1079	217	15	1311	2021-02-28	all
30-34	1595	245	17	1857	2021-02-28	all
35-39	1668	302	40	2010	2021-02-28	all
40-44	1830	358	72	2260	2021-02-28	all
45-49	2481	508	153	3142	2021-02-28	all
50-54	3381	663	253	4297	2021-02-28	all
55-59	3825	886	443	5154	2021-02-28	all
60-64	3694	966	718	5378	2021-02-28	all
65-69	3371	1146	997	5514	2021-02-28	all
70-74	4101	1576	1714	7391	2021-02-28	all
75-79	4067	1835	2137	8039	2021-02-28	all
80-84	3865	2158	2550	8573	2021-02-28	all
85-89	3219	2089	2492	7800	2021-02-28	all
90+	2149	1596	2165	5910	2021-02-28	all
0-4	243	16	1	260	2021-03-01	female
5-9	70	16	0	86	2021-03-01	female
10-14	121	21	0	142	2021-03-01	female
15-19	267	38	3	308	2021-03-01	female
20-24	545	66	3	614	2021-03-01	female
25-29	762	117	8	887	2021-03-01	female
30-34	994	142	8	1144	2021-03-01	female
35-39	894	151	19	1064	2021-03-01	female
40-44	807	158	29	994	2021-03-01	female
45-49	1031	185	63	1279	2021-03-01	female
50-54	1463	253	98	1814	2021-03-01	female
55-59	1636	329	161	2126	2021-03-01	female
60-64	1489	372	237	2098	2021-03-01	female
65-69	1417	463	353	2233	2021-03-01	female
70-74	1728	665	640	3033	2021-03-01	female
75-79	1862	786	788	3436	2021-03-01	female
80-84	1915	1108	1010	4033	2021-03-01	female
85-89	1806	1125	1072	4003	2021-03-01	female
90+	1388	998	1095	3481	2021-03-01	female
0-4	332	37	4	373	2021-03-01	male
5-9	72	10	0	82	2021-03-01	male
10-14	124	24	0	148	2021-03-01	male
15-19	160	35	0	195	2021-03-01	male
20-24	231	56	4	291	2021-03-01	male
25-29	317	100	7	424	2021-03-01	male
30-34	604	104	9	717	2021-03-01	male
35-39	777	151	21	949	2021-03-01	male
40-44	1024	200	43	1267	2021-03-01	male
45-49	1453	323	90	1866	2021-03-01	male
50-54	1925	411	155	2491	2021-03-01	male
55-59	2194	559	284	3037	2021-03-01	male
60-64	2213	594	481	3288	2021-03-01	male
65-69	1960	684	646	3290	2021-03-01	male
70-74	2380	913	1076	4369	2021-03-01	male
75-79	2212	1052	1351	4615	2021-03-01	male
80-84	1955	1055	1547	4557	2021-03-01	male
85-89	1420	966	1425	3811	2021-03-01	male
90+	763	601	1071	2435	2021-03-01	male
0-4	575	53	5	633	2021-03-01	all
5-9	142	26	0	168	2021-03-01	all
10-14	245	45	0	290	2021-03-01	all
15-19	427	73	3	503	2021-03-01	all
20-24	776	122	7	905	2021-03-01	all
25-29	1079	217	15	1311	2021-03-01	all
30-34	1598	246	17	1861	2021-03-01	all
35-39	1671	302	40	2013	2021-03-01	all
40-44	1831	358	72	2261	2021-03-01	all
45-49	2484	508	153	3145	2021-03-01	all
50-54	3388	664	253	4305	2021-03-01	all
55-59	3830	888	445	5163	2021-03-01	all
60-64	3702	966	718	5386	2021-03-01	all
65-69	3377	1147	999	5523	2021-03-01	all
70-74	4108	1578	1716	7402	2021-03-01	all
75-79	4074	1838	2139	8051	2021-03-01	all
80-84	3870	2163	2557	8590	2021-03-01	all
85-89	3226	2091	2497	7814	2021-03-01	all
90+	2151	1599	2166	5916	2021-03-01	all
0-4	243	16	1	260	2021-03-01	female
5-9	70	16	0	86	2021-03-01	female
10-14	121	21	0	142	2021-03-01	female
15-19	267	38	3	308	2021-03-01	female
20-24	545	66	3	614	2021-03-01	female
25-29	762	117	8	887	2021-03-01	female
30-34	994	142	8	1144	2021-03-01	female
35-39	894	151	19	1064	2021-03-01	female
40-44	807	158	29	994	2021-03-01	female
45-49	1031	185	63	1279	2021-03-01	female
50-54	1463	253	98	1814	2021-03-01	female
55-59	1636	329	161	2126	2021-03-01	female
60-64	1489	372	237	2098	2021-03-01	female
65-69	1417	463	353	2233	2021-03-01	female
70-74	1728	665	640	3033	2021-03-01	female
75-79	1862	786	788	3436	2021-03-01	female
80-84	1915	1108	1010	4033	2021-03-01	female
85-89	1806	1125	1072	4003	2021-03-01	female
90+	1388	998	1095	3481	2021-03-01	female
0-4	332	37	4	373	2021-03-01	male
5-9	72	10	0	82	2021-03-01	male
10-14	124	24	0	148	2021-03-01	male
15-19	160	35	0	195	2021-03-01	male
20-24	231	56	4	291	2021-03-01	male
25-29	317	100	7	424	2021-03-01	male
30-34	604	104	9	717	2021-03-01	male
35-39	777	151	21	949	2021-03-01	male
40-44	1024	200	43	1267	2021-03-01	male
45-49	1453	323	90	1866	2021-03-01	male
50-54	1925	411	155	2491	2021-03-01	male
55-59	2194	559	284	3037	2021-03-01	male
60-64	2213	594	481	3288	2021-03-01	male
65-69	1960	684	646	3290	2021-03-01	male
70-74	2380	913	1076	4369	2021-03-01	male
75-79	2212	1052	1351	4615	2021-03-01	male
80-84	1955	1055	1547	4557	2021-03-01	male
85-89	1420	966	1425	3811	2021-03-01	male
90+	763	601	1071	2435	2021-03-01	male
0-4	575	53	5	633	2021-03-01	all
5-9	142	26	0	168	2021-03-01	all
10-14	245	45	0	290	2021-03-01	all
15-19	427	73	3	503	2021-03-01	all
20-24	776	122	7	905	2021-03-01	all
25-29	1079	217	15	1311	2021-03-01	all
30-34	1598	246	17	1861	2021-03-01	all
35-39	1671	302	40	2013	2021-03-01	all
40-44	1831	358	72	2261	2021-03-01	all
45-49	2484	508	153	3145	2021-03-01	all
50-54	3388	664	253	4305	2021-03-01	all
55-59	3830	888	445	5163	2021-03-01	all
60-64	3702	966	718	5386	2021-03-01	all
65-69	3377	1147	999	5523	2021-03-01	all
70-74	4108	1578	1716	7402	2021-03-01	all
75-79	4074	1838	2139	8051	2021-03-01	all
80-84	3870	2163	2557	8590	2021-03-01	all
85-89	3226	2091	2497	7814	2021-03-01	all
90+	2151	1599	2166	5916	2021-03-01	all
0-4	251	16	1	268	2021-03-03	female
5-9	70	16	0	86	2021-03-03	female
10-14	124	20	0	144	2021-03-03	female
15-19	272	39	3	314	2021-03-03	female
20-24	555	68	3	626	2021-03-03	female
25-29	774	120	8	902	2021-03-03	female
30-34	1012	148	8	1168	2021-03-03	female
35-39	908	156	19	1083	2021-03-03	female
40-44	826	165	29	1020	2021-03-03	female
45-49	1059	191	64	1314	2021-03-03	female
50-54	1499	258	99	1856	2021-03-03	female
55-59	1674	337	167	2178	2021-03-03	female
60-64	1521	382	250	2153	2021-03-03	female
65-69	1456	476	369	2301	2021-03-03	female
70-74	1761	683	652	3096	2021-03-03	female
75-79	1908	804	803	3515	2021-03-03	female
80-84	1956	1128	1033	4117	2021-03-03	female
85-89	1849	1157	1093	4099	2021-03-03	female
90+	1416	1015	1120	3551	2021-03-03	female
0-4	337	38	4	379	2021-03-03	male
5-9	74	10	0	84	2021-03-03	male
10-14	124	25	0	149	2021-03-03	male
15-19	165	38	0	203	2021-03-03	male
20-24	235	59	4	298	2021-03-03	male
25-29	331	104	7	442	2021-03-03	male
30-34	616	106	9	731	2021-03-03	male
35-39	799	154	23	976	2021-03-03	male
40-44	1050	206	44	1300	2021-03-03	male
45-49	1489	334	94	1917	2021-03-03	male
50-54	1974	425	160	2559	2021-03-03	male
55-59	2249	579	293	3121	2021-03-03	male
60-64	2278	615	493	3386	2021-03-03	male
65-69	2007	691	672	3370	2021-03-03	male
70-74	2433	930	1097	4460	2021-03-03	male
75-79	2259	1070	1388	4717	2021-03-03	male
80-84	1997	1091	1583	4671	2021-03-03	male
85-89	1448	984	1451	3883	2021-03-03	male
90+	787	612	1097	2496	2021-03-03	male
0-4	588	54	5	647	2021-03-03	all
5-9	144	26	0	170	2021-03-03	all
10-14	248	45	0	293	2021-03-03	all
15-19	437	77	3	517	2021-03-03	all
20-24	790	127	7	924	2021-03-03	all
25-29	1105	224	15	1344	2021-03-03	all
30-34	1628	254	17	1899	2021-03-03	all
35-39	1707	310	42	2059	2021-03-03	all
40-44	1876	371	73	2320	2021-03-03	all
45-49	2548	525	158	3231	2021-03-03	all
50-54	3473	683	259	4415	2021-03-03	all
55-59	3923	916	460	5299	2021-03-03	all
60-64	3799	997	743	5539	2021-03-03	all
65-69	3463	1167	1041	5671	2021-03-03	all
70-74	4194	1613	1749	7556	2021-03-03	all
75-79	4167	1874	2191	8232	2021-03-03	all
80-84	3953	2219	2616	8788	2021-03-03	all
85-89	3297	2141	2544	7982	2021-03-03	all
90+	2203	1627	2217	6047	2021-03-03	all
0-4	254	17	1	272	2021-03-04	female
5-9	71	16	0	87	2021-03-04	female
10-14	125	20	0	145	2021-03-04	female
15-19	272	40	3	315	2021-03-04	female
20-24	561	69	3	633	2021-03-04	female
25-29	783	122	8	913	2021-03-04	female
30-34	1027	150	8	1185	2021-03-04	female
35-39	916	160	19	1095	2021-03-04	female
40-44	833	167	29	1029	2021-03-04	female
45-49	1079	191	66	1336	2021-03-04	female
50-54	1521	261	100	1882	2021-03-04	female
55-59	1691	339	169	2199	2021-03-04	female
60-64	1534	388	254	2176	2021-03-04	female
65-69	1471	480	372	2323	2021-03-04	female
70-74	1785	687	665	3137	2021-03-04	female
75-79	1936	810	814	3560	2021-03-04	female
80-84	1973	1142	1046	4161	2021-03-04	female
85-89	1870	1170	1105	4145	2021-03-04	female
90+	1433	1024	1134	3591	2021-03-04	female
0-4	340	38	4	382	2021-03-04	male
5-9	75	11	0	86	2021-03-04	male
10-14	125	25	0	150	2021-03-04	male
15-19	166	40	0	206	2021-03-04	male
20-24	235	60	4	299	2021-03-04	male
25-29	335	106	7	448	2021-03-04	male
30-34	626	106	9	741	2021-03-04	male
35-39	813	156	24	993	2021-03-04	male
40-44	1062	209	47	1318	2021-03-04	male
45-49	1509	340	96	1945	2021-03-04	male
50-54	2000	429	160	2589	2021-03-04	male
55-59	2280	589	298	3167	2021-03-04	male
60-64	2309	620	496	3425	2021-03-04	male
65-69	2031	703	682	3416	2021-03-04	male
70-74	2455	946	1102	4503	2021-03-04	male
75-79	2289	1077	1406	4772	2021-03-04	male
80-84	2021	1109	1596	4726	2021-03-04	male
85-89	1465	989	1464	3918	2021-03-04	male
90+	803	618	1105	2526	2021-03-04	male
0-4	594	55	5	654	2021-03-04	all
5-9	146	27	0	173	2021-03-04	all
10-14	250	45	0	295	2021-03-04	all
15-19	438	80	3	521	2021-03-04	all
20-24	796	129	7	932	2021-03-04	all
25-29	1118	228	15	1361	2021-03-04	all
30-34	1653	256	17	1926	2021-03-04	all
35-39	1729	316	43	2088	2021-03-04	all
40-44	1895	376	76	2347	2021-03-04	all
45-49	2588	531	162	3281	2021-03-04	all
50-54	3521	690	260	4471	2021-03-04	all
55-59	3971	928	467	5366	2021-03-04	all
60-64	3843	1008	750	5601	2021-03-04	all
65-69	3502	1183	1054	5739	2021-03-04	all
70-74	4240	1633	1767	7640	2021-03-04	all
75-79	4225	1887	2220	8332	2021-03-04	all
80-84	3994	2251	2642	8887	2021-03-04	all
85-89	3335	2159	2569	8063	2021-03-04	all
90+	2236	1642	2239	6117	2021-03-04	all
0-4	256	17	1	274	2021-03-05	female
5-9	71	16	0	87	2021-03-05	female
10-14	127	21	0	148	2021-03-05	female
15-19	274	41	3	318	2021-03-05	female
20-24	569	70	3	642	2021-03-05	female
25-29	788	121	8	917	2021-03-05	female
30-34	1038	151	8	1197	2021-03-05	female
35-39	926	160	19	1105	2021-03-05	female
40-44	839	170	30	1039	2021-03-05	female
45-49	1099	193	68	1360	2021-03-05	female
50-54	1540	265	104	1909	2021-03-05	female
55-59	1723	345	177	2245	2021-03-05	female
60-64	1560	390	259	2209	2021-03-05	female
65-69	1496	488	379	2363	2021-03-05	female
70-74	1805	695	673	3173	2021-03-05	female
75-79	1957	821	823	3601	2021-03-05	female
80-84	1997	1160	1056	4213	2021-03-05	female
85-89	1889	1181	1121	4191	2021-03-05	female
90+	1456	1041	1150	3647	2021-03-05	female
0-4	343	39	4	386	2021-03-05	male
5-9	75	11	0	86	2021-03-05	male
10-14	126	25	0	151	2021-03-05	male
15-19	168	41	0	209	2021-03-05	male
20-24	237	60	4	301	2021-03-05	male
25-29	340	106	7	453	2021-03-05	male
30-34	633	108	10	751	2021-03-05	male
35-39	829	160	27	1016	2021-03-05	male
40-44	1078	211	47	1336	2021-03-05	male
45-49	1520	343	97	1960	2021-03-05	male
50-54	2033	436	162	2631	2021-03-05	male
55-59	2319	597	305	3221	2021-03-05	male
60-64	2332	631	508	3471	2021-03-05	male
65-69	2060	714	690	3464	2021-03-05	male
70-74	2491	955	1119	4565	2021-03-05	male
75-79	2321	1090	1424	4835	2021-03-05	male
80-84	2037	1115	1618	4770	2021-03-05	male
85-89	1481	999	1486	3966	2021-03-05	male
90+	812	623	1124	2559	2021-03-05	male
0-4	599	56	5	660	2021-03-05	all
5-9	146	27	0	173	2021-03-05	all
10-14	253	46	0	299	2021-03-05	all
15-19	442	82	3	527	2021-03-05	all
20-24	806	130	7	943	2021-03-05	all
25-29	1128	227	15	1370	2021-03-05	all
30-34	1671	259	18	1948	2021-03-05	all
35-39	1755	320	46	2121	2021-03-05	all
40-44	1917	381	77	2375	2021-03-05	all
45-49	2619	536	165	3320	2021-03-05	all
50-54	3573	701	266	4540	2021-03-05	all
55-59	4042	942	482	5466	2021-03-05	all
60-64	3892	1021	767	5680	2021-03-05	all
65-69	3556	1202	1069	5827	2021-03-05	all
70-74	4296	1650	1792	7738	2021-03-05	all
75-79	4278	1911	2247	8436	2021-03-05	all
80-84	4034	2275	2674	8983	2021-03-05	all
85-89	3370	2180	2607	8157	2021-03-05	all
90+	2268	1664	2274	6206	2021-03-05	all
0-4	261	18	1	280	2021-03-07	female
5-9	71	16	0	87	2021-03-07	female
10-14	128	23	0	151	2021-03-07	female
15-19	276	42	3	321	2021-03-07	female
20-24	572	71	3	646	2021-03-07	female
25-29	791	122	8	921	2021-03-07	female
30-34	1042	155	8	1205	2021-03-07	female
35-39	937	161	19	1117	2021-03-07	female
40-44	844	170	31	1045	2021-03-07	female
45-49	1114	194	68	1376	2021-03-07	female
50-54	1559	270	105	1934	2021-03-07	female
55-59	1742	349	178	2269	2021-03-07	female
60-64	1578	393	267	2238	2021-03-07	female
65-69	1509	495	383	2387	2021-03-07	female
70-74	1835	703	678	3216	2021-03-07	female
75-79	1972	828	833	3633	2021-03-07	female
80-84	2015	1180	1069	4264	2021-03-07	female
85-89	1907	1198	1135	4240	2021-03-07	female
90+	1473	1053	1159	3685	2021-03-07	female
0-4	345	39	4	388	2021-03-07	male
5-9	75	12	0	87	2021-03-07	male
10-14	126	26	0	152	2021-03-07	male
15-19	168	44	0	212	2021-03-07	male
20-24	238	60	4	302	2021-03-07	male
25-29	345	106	8	459	2021-03-07	male
30-34	636	109	10	755	2021-03-07	male
35-39	846	161	30	1037	2021-03-07	male
40-44	1091	213	48	1352	2021-03-07	male
45-49	1538	346	97	1981	2021-03-07	male
50-54	2068	443	165	2676	2021-03-07	male
55-59	2351	606	309	3266	2021-03-07	male
60-64	2363	647	517	3527	2021-03-07	male
65-69	2083	722	697	3502	2021-03-07	male
70-74	2516	968	1129	4613	2021-03-07	male
75-79	2337	1103	1431	4871	2021-03-07	male
80-84	2050	1133	1631	4814	2021-03-07	male
85-89	1495	1011	1503	4009	2021-03-07	male
90+	827	629	1138	2594	2021-03-07	male
0-4	606	57	5	668	2021-03-07	all
5-9	146	28	0	174	2021-03-07	all
10-14	254	49	0	303	2021-03-07	all
15-19	444	86	3	533	2021-03-07	all
20-24	810	131	7	948	2021-03-07	all
25-29	1136	228	16	1380	2021-03-07	all
30-34	1678	264	18	1960	2021-03-07	all
35-39	1783	322	49	2154	2021-03-07	all
40-44	1935	383	79	2397	2021-03-07	all
45-49	2652	540	165	3357	2021-03-07	all
50-54	3627	713	270	4610	2021-03-07	all
55-59	4093	955	487	5535	2021-03-07	all
60-64	3941	1040	784	5765	2021-03-07	all
65-69	3592	1217	1080	5889	2021-03-07	all
70-74	4351	1671	1807	7829	2021-03-07	all
75-79	4309	1931	2264	8504	2021-03-07	all
80-84	4065	2313	2700	9078	2021-03-07	all
85-89	3402	2209	2638	8249	2021-03-07	all
90+	2300	1682	2297	6279	2021-03-07	all
0-4	261	18	1	280	2021-03-07	female
5-9	71	16	0	87	2021-03-07	female
10-14	128	23	0	151	2021-03-07	female
15-19	276	42	3	321	2021-03-07	female
20-24	572	71	3	646	2021-03-07	female
25-29	791	122	8	921	2021-03-07	female
30-34	1042	155	8	1205	2021-03-07	female
35-39	937	161	19	1117	2021-03-07	female
40-44	844	170	31	1045	2021-03-07	female
45-49	1114	194	68	1376	2021-03-07	female
50-54	1559	270	105	1934	2021-03-07	female
55-59	1742	349	178	2269	2021-03-07	female
60-64	1578	393	267	2238	2021-03-07	female
65-69	1509	495	383	2387	2021-03-07	female
70-74	1835	703	678	3216	2021-03-07	female
75-79	1972	828	833	3633	2021-03-07	female
80-84	2015	1180	1069	4264	2021-03-07	female
85-89	1907	1198	1135	4240	2021-03-07	female
90+	1473	1053	1159	3685	2021-03-07	female
0-4	345	39	4	388	2021-03-07	male
5-9	75	12	0	87	2021-03-07	male
10-14	126	26	0	152	2021-03-07	male
15-19	168	44	0	212	2021-03-07	male
20-24	238	60	4	302	2021-03-07	male
25-29	345	106	8	459	2021-03-07	male
30-34	636	109	10	755	2021-03-07	male
35-39	846	161	30	1037	2021-03-07	male
40-44	1091	213	48	1352	2021-03-07	male
45-49	1538	346	97	1981	2021-03-07	male
50-54	2068	443	165	2676	2021-03-07	male
55-59	2351	606	309	3266	2021-03-07	male
60-64	2363	647	517	3527	2021-03-07	male
65-69	2083	722	697	3502	2021-03-07	male
70-74	2516	968	1129	4613	2021-03-07	male
75-79	2337	1103	1431	4871	2021-03-07	male
80-84	2050	1133	1631	4814	2021-03-07	male
85-89	1495	1011	1503	4009	2021-03-07	male
90+	827	629	1138	2594	2021-03-07	male
0-4	606	57	5	668	2021-03-07	all
5-9	146	28	0	174	2021-03-07	all
10-14	254	49	0	303	2021-03-07	all
15-19	444	86	3	533	2021-03-07	all
20-24	810	131	7	948	2021-03-07	all
25-29	1136	228	16	1380	2021-03-07	all
30-34	1678	264	18	1960	2021-03-07	all
35-39	1783	322	49	2154	2021-03-07	all
40-44	1935	383	79	2397	2021-03-07	all
45-49	2652	540	165	3357	2021-03-07	all
50-54	3627	713	270	4610	2021-03-07	all
55-59	4093	955	487	5535	2021-03-07	all
60-64	3941	1040	784	5765	2021-03-07	all
65-69	3592	1217	1080	5889	2021-03-07	all
70-74	4351	1671	1807	7829	2021-03-07	all
75-79	4309	1931	2264	8504	2021-03-07	all
80-84	4065	2313	2700	9078	2021-03-07	all
85-89	3402	2209	2638	8249	2021-03-07	all
90+	2300	1682	2297	6279	2021-03-07	all
0-4	261	18	1	280	2021-03-07	female
5-9	71	16	0	87	2021-03-07	female
10-14	128	23	0	151	2021-03-07	female
15-19	276	42	3	321	2021-03-07	female
20-24	572	71	3	646	2021-03-07	female
25-29	791	122	8	921	2021-03-07	female
30-34	1042	155	8	1205	2021-03-07	female
35-39	937	161	19	1117	2021-03-07	female
40-44	844	170	31	1045	2021-03-07	female
45-49	1114	194	68	1376	2021-03-07	female
50-54	1559	270	105	1934	2021-03-07	female
55-59	1742	349	178	2269	2021-03-07	female
60-64	1578	393	267	2238	2021-03-07	female
65-69	1509	495	383	2387	2021-03-07	female
70-74	1835	703	678	3216	2021-03-07	female
75-79	1972	828	833	3633	2021-03-07	female
80-84	2015	1180	1069	4264	2021-03-07	female
85-89	1907	1198	1135	4240	2021-03-07	female
90+	1473	1053	1159	3685	2021-03-07	female
0-4	345	39	4	388	2021-03-07	male
5-9	75	12	0	87	2021-03-07	male
10-14	126	26	0	152	2021-03-07	male
15-19	168	44	0	212	2021-03-07	male
20-24	238	60	4	302	2021-03-07	male
25-29	345	106	8	459	2021-03-07	male
30-34	636	109	10	755	2021-03-07	male
35-39	846	161	30	1037	2021-03-07	male
40-44	1091	213	48	1352	2021-03-07	male
45-49	1538	346	97	1981	2021-03-07	male
50-54	2068	443	165	2676	2021-03-07	male
55-59	2351	606	309	3266	2021-03-07	male
60-64	2363	647	517	3527	2021-03-07	male
65-69	2083	722	697	3502	2021-03-07	male
70-74	2516	968	1129	4613	2021-03-07	male
75-79	2337	1103	1431	4871	2021-03-07	male
80-84	2050	1133	1631	4814	2021-03-07	male
85-89	1495	1011	1503	4009	2021-03-07	male
90+	827	629	1138	2594	2021-03-07	male
0-4	606	57	5	668	2021-03-07	all
5-9	146	28	0	174	2021-03-07	all
10-14	254	49	0	303	2021-03-07	all
15-19	444	86	3	533	2021-03-07	all
20-24	810	131	7	948	2021-03-07	all
25-29	1136	228	16	1380	2021-03-07	all
30-34	1678	264	18	1960	2021-03-07	all
35-39	1783	322	49	2154	2021-03-07	all
40-44	1935	383	79	2397	2021-03-07	all
45-49	2652	540	165	3357	2021-03-07	all
50-54	3627	713	270	4610	2021-03-07	all
55-59	4093	955	487	5535	2021-03-07	all
60-64	3941	1040	784	5765	2021-03-07	all
65-69	3592	1217	1080	5889	2021-03-07	all
70-74	4351	1671	1807	7829	2021-03-07	all
75-79	4309	1931	2264	8504	2021-03-07	all
80-84	4065	2313	2700	9078	2021-03-07	all
85-89	3402	2209	2638	8249	2021-03-07	all
90+	2300	1682	2297	6279	2021-03-07	all
0-4	268	18	1	287	2021-03-10	female
5-9	71	16	0	87	2021-03-10	female
10-14	133	23	0	156	2021-03-10	female
15-19	276	42	3	321	2021-03-10	female
20-24	580	73	3	656	2021-03-10	female
25-29	799	122	8	929	2021-03-10	female
30-34	1060	155	8	1223	2021-03-10	female
35-39	953	164	19	1136	2021-03-10	female
40-44	864	176	32	1072	2021-03-10	female
45-49	1137	199	73	1409	2021-03-10	female
50-54	1588	277	108	1973	2021-03-10	female
55-59	1781	358	184	2323	2021-03-10	female
60-64	1616	409	274	2299	2021-03-10	female
65-69	1549	511	392	2452	2021-03-10	female
70-74	1874	717	691	3282	2021-03-10	female
75-79	2010	850	854	3714	2021-03-10	female
80-84	2042	1208	1085	4335	2021-03-10	female
85-89	1947	1216	1156	4319	2021-03-10	female
90+	1502	1066	1176	3744	2021-03-10	female
0-4	351	41	4	396	2021-03-10	male
5-9	77	13	0	90	2021-03-10	male
10-14	126	26	0	152	2021-03-10	male
15-19	170	45	0	215	2021-03-10	male
20-24	244	61	4	309	2021-03-10	male
25-29	351	109	8	468	2021-03-10	male
30-34	654	112	10	776	2021-03-10	male
35-39	864	165	30	1059	2021-03-10	male
40-44	1116	219	50	1385	2021-03-10	male
45-49	1584	358	100	2042	2021-03-10	male
50-54	2115	451	173	2739	2021-03-10	male
55-59	2394	625	316	3335	2021-03-10	male
60-64	2415	670	540	3625	2021-03-10	male
65-69	2128	738	710	3576	2021-03-10	male
70-74	2551	993	1152	4696	2021-03-10	male
75-79	2380	1127	1457	4964	2021-03-10	male
80-84	2081	1175	1663	4919	2021-03-10	male
85-89	1521	1036	1532	4089	2021-03-10	male
90+	842	640	1166	2648	2021-03-10	male
0-4	619	59	5	683	2021-03-10	all
5-9	148	29	0	177	2021-03-10	all
10-14	259	49	0	308	2021-03-10	all
15-19	446	87	3	536	2021-03-10	all
20-24	824	134	7	965	2021-03-10	all
25-29	1150	231	16	1397	2021-03-10	all
30-34	1714	267	18	1999	2021-03-10	all
35-39	1817	329	49	2195	2021-03-10	all
40-44	1980	395	82	2457	2021-03-10	all
45-49	2721	557	173	3451	2021-03-10	all
50-54	3703	728	281	4712	2021-03-10	all
55-59	4175	983	500	5658	2021-03-10	all
60-64	4031	1079	814	5924	2021-03-10	all
65-69	3677	1249	1102	6028	2021-03-10	all
70-74	4425	1710	1843	7978	2021-03-10	all
75-79	4390	1977	2311	8678	2021-03-10	all
80-84	4123	2383	2748	9254	2021-03-10	all
85-89	3468	2252	2688	8408	2021-03-10	all
90+	2344	1706	2342	6392	2021-03-10	all
0-4	268	18	1	287	2021-03-10	female
5-9	71	16	0	87	2021-03-10	female
10-14	133	23	0	156	2021-03-10	female
15-19	276	42	3	321	2021-03-10	female
20-24	580	73	3	656	2021-03-10	female
25-29	799	122	8	929	2021-03-10	female
30-34	1060	155	8	1223	2021-03-10	female
35-39	953	164	19	1136	2021-03-10	female
40-44	864	176	32	1072	2021-03-10	female
45-49	1137	199	73	1409	2021-03-10	female
50-54	1588	277	108	1973	2021-03-10	female
55-59	1781	358	184	2323	2021-03-10	female
60-64	1616	409	274	2299	2021-03-10	female
65-69	1549	511	392	2452	2021-03-10	female
70-74	1874	717	691	3282	2021-03-10	female
75-79	2010	850	854	3714	2021-03-10	female
80-84	2042	1208	1085	4335	2021-03-10	female
85-89	1947	1216	1156	4319	2021-03-10	female
90+	1502	1066	1176	3744	2021-03-10	female
0-4	351	41	4	396	2021-03-10	male
5-9	77	13	0	90	2021-03-10	male
10-14	126	26	0	152	2021-03-10	male
15-19	170	45	0	215	2021-03-10	male
20-24	244	61	4	309	2021-03-10	male
25-29	351	109	8	468	2021-03-10	male
30-34	654	112	10	776	2021-03-10	male
35-39	864	165	30	1059	2021-03-10	male
40-44	1116	219	50	1385	2021-03-10	male
45-49	1584	358	100	2042	2021-03-10	male
50-54	2115	451	173	2739	2021-03-10	male
55-59	2394	625	316	3335	2021-03-10	male
60-64	2415	670	540	3625	2021-03-10	male
65-69	2128	738	710	3576	2021-03-10	male
70-74	2551	993	1152	4696	2021-03-10	male
75-79	2380	1127	1457	4964	2021-03-10	male
80-84	2081	1175	1663	4919	2021-03-10	male
85-89	1521	1036	1532	4089	2021-03-10	male
90+	842	640	1166	2648	2021-03-10	male
0-4	619	59	5	683	2021-03-10	all
5-9	148	29	0	177	2021-03-10	all
10-14	259	49	0	308	2021-03-10	all
15-19	446	87	3	536	2021-03-10	all
20-24	824	134	7	965	2021-03-10	all
25-29	1150	231	16	1397	2021-03-10	all
30-34	1714	267	18	1999	2021-03-10	all
35-39	1817	329	49	2195	2021-03-10	all
40-44	1980	395	82	2457	2021-03-10	all
45-49	2721	557	173	3451	2021-03-10	all
50-54	3703	728	281	4712	2021-03-10	all
55-59	4175	983	500	5658	2021-03-10	all
60-64	4031	1079	814	5924	2021-03-10	all
65-69	3677	1249	1102	6028	2021-03-10	all
70-74	4425	1710	1843	7978	2021-03-10	all
75-79	4390	1977	2311	8678	2021-03-10	all
80-84	4123	2383	2748	9254	2021-03-10	all
85-89	3468	2252	2688	8408	2021-03-10	all
90+	2344	1706	2342	6392	2021-03-10	all
0-4	268	18	1	287	2021-03-10	female
5-9	71	16	0	87	2021-03-10	female
10-14	133	23	0	156	2021-03-10	female
15-19	276	42	3	321	2021-03-10	female
20-24	580	73	3	656	2021-03-10	female
25-29	799	122	8	929	2021-03-10	female
30-34	1060	155	8	1223	2021-03-10	female
35-39	953	164	19	1136	2021-03-10	female
40-44	864	176	32	1072	2021-03-10	female
45-49	1137	199	73	1409	2021-03-10	female
50-54	1588	277	108	1973	2021-03-10	female
55-59	1781	358	184	2323	2021-03-10	female
60-64	1616	409	274	2299	2021-03-10	female
65-69	1549	511	392	2452	2021-03-10	female
70-74	1874	717	691	3282	2021-03-10	female
75-79	2010	850	854	3714	2021-03-10	female
80-84	2042	1208	1085	4335	2021-03-10	female
85-89	1947	1216	1156	4319	2021-03-10	female
90+	1502	1066	1176	3744	2021-03-10	female
0-4	351	41	4	396	2021-03-10	male
5-9	77	13	0	90	2021-03-10	male
10-14	126	26	0	152	2021-03-10	male
15-19	170	45	0	215	2021-03-10	male
20-24	244	61	4	309	2021-03-10	male
25-29	351	109	8	468	2021-03-10	male
30-34	654	112	10	776	2021-03-10	male
35-39	864	165	30	1059	2021-03-10	male
40-44	1116	219	50	1385	2021-03-10	male
45-49	1584	358	100	2042	2021-03-10	male
50-54	2115	451	173	2739	2021-03-10	male
55-59	2394	625	316	3335	2021-03-10	male
60-64	2415	670	540	3625	2021-03-10	male
65-69	2128	738	710	3576	2021-03-10	male
70-74	2551	993	1152	4696	2021-03-10	male
75-79	2380	1127	1457	4964	2021-03-10	male
80-84	2081	1175	1663	4919	2021-03-10	male
85-89	1521	1036	1532	4089	2021-03-10	male
90+	842	640	1166	2648	2021-03-10	male
0-4	619	59	5	683	2021-03-10	all
5-9	148	29	0	177	2021-03-10	all
10-14	259	49	0	308	2021-03-10	all
15-19	446	87	3	536	2021-03-10	all
20-24	824	134	7	965	2021-03-10	all
25-29	1150	231	16	1397	2021-03-10	all
30-34	1714	267	18	1999	2021-03-10	all
35-39	1817	329	49	2195	2021-03-10	all
40-44	1980	395	82	2457	2021-03-10	all
45-49	2721	557	173	3451	2021-03-10	all
50-54	3703	728	281	4712	2021-03-10	all
55-59	4175	983	500	5658	2021-03-10	all
60-64	4031	1079	814	5924	2021-03-10	all
65-69	3677	1249	1102	6028	2021-03-10	all
70-74	4425	1710	1843	7978	2021-03-10	all
75-79	4390	1977	2311	8678	2021-03-10	all
80-84	4123	2383	2748	9254	2021-03-10	all
85-89	3468	2252	2688	8408	2021-03-10	all
90+	2344	1706	2342	6392	2021-03-10	all
0-4	276	19	1	296	2021-03-13	female
5-9	73	16	0	89	2021-03-13	female
10-14	133	24	0	157	2021-03-13	female
15-19	282	44	3	329	2021-03-13	female
20-24	595	75	3	673	2021-03-13	female
25-29	812	122	11	945	2021-03-13	female
30-34	1082	158	10	1250	2021-03-13	female
35-39	980	166	19	1165	2021-03-13	female
40-44	887	180	33	1100	2021-03-13	female
45-49	1181	203	77	1461	2021-03-13	female
50-54	1624	288	110	2022	2021-03-13	female
55-59	1823	368	191	2382	2021-03-13	female
60-64	1665	429	292	2386	2021-03-13	female
65-69	1585	525	408	2518	2021-03-13	female
70-74	1922	740	707	3369	2021-03-13	female
75-79	2043	873	883	3799	2021-03-13	female
80-84	2095	1240	1119	4454	2021-03-13	female
85-89	2005	1246	1188	4439	2021-03-13	female
90+	1544	1098	1208	3850	2021-03-13	female
0-4	358	42	4	404	2021-03-13	male
5-9	81	13	0	94	2021-03-13	male
10-14	130	26	0	156	2021-03-13	male
15-19	171	47	0	218	2021-03-13	male
20-24	252	61	6	319	2021-03-13	male
25-29	364	109	8	481	2021-03-13	male
30-34	672	117	10	799	2021-03-13	male
35-39	886	166	31	1083	2021-03-13	male
40-44	1144	227	51	1422	2021-03-13	male
45-49	1638	370	103	2111	2021-03-13	male
50-54	2176	465	181	2822	2021-03-13	male
55-59	2468	649	328	3445	2021-03-13	male
60-64	2498	692	565	3755	2021-03-13	male
65-69	2206	760	736	3702	2021-03-13	male
70-74	2630	1021	1188	4839	2021-03-13	male
75-79	2440	1159	1499	5098	2021-03-13	male
80-84	2135	1208	1714	5057	2021-03-13	male
85-89	1555	1065	1572	4192	2021-03-13	male
90+	872	650	1197	2719	2021-03-13	male
0-4	634	61	5	700	2021-03-13	all
5-9	154	29	0	183	2021-03-13	all
10-14	263	50	0	313	2021-03-13	all
15-19	453	91	3	547	2021-03-13	all
20-24	847	136	9	992	2021-03-13	all
25-29	1176	231	19	1426	2021-03-13	all
30-34	1754	275	20	2049	2021-03-13	all
35-39	1866	332	50	2248	2021-03-13	all
40-44	2031	407	84	2522	2021-03-13	all
45-49	2819	573	180	3572	2021-03-13	all
50-54	3800	753	291	4844	2021-03-13	all
55-59	4291	1017	519	5827	2021-03-13	all
60-64	4163	1121	857	6141	2021-03-13	all
65-69	3791	1285	1144	6220	2021-03-13	all
70-74	4552	1761	1895	8208	2021-03-13	all
75-79	4483	2032	2382	8897	2021-03-13	all
80-84	4230	2448	2833	9511	2021-03-13	all
85-89	3560	2311	2760	8631	2021-03-13	all
90+	2416	1748	2405	6569	2021-03-13	all
0-4	276	19	1	296	2021-03-13	female
5-9	73	16	0	89	2021-03-13	female
10-14	133	24	0	157	2021-03-13	female
15-19	282	44	3	329	2021-03-13	female
20-24	595	75	3	673	2021-03-13	female
25-29	812	122	11	945	2021-03-13	female
30-34	1082	158	10	1250	2021-03-13	female
35-39	980	166	19	1165	2021-03-13	female
40-44	887	180	33	1100	2021-03-13	female
45-49	1181	203	77	1461	2021-03-13	female
50-54	1624	288	110	2022	2021-03-13	female
55-59	1823	368	191	2382	2021-03-13	female
60-64	1665	429	292	2386	2021-03-13	female
65-69	1585	525	408	2518	2021-03-13	female
70-74	1922	740	707	3369	2021-03-13	female
75-79	2043	873	883	3799	2021-03-13	female
80-84	2095	1240	1119	4454	2021-03-13	female
85-89	2005	1246	1188	4439	2021-03-13	female
90+	1544	1098	1208	3850	2021-03-13	female
0-4	358	42	4	404	2021-03-13	male
5-9	81	13	0	94	2021-03-13	male
10-14	130	26	0	156	2021-03-13	male
15-19	171	47	0	218	2021-03-13	male
20-24	252	61	6	319	2021-03-13	male
25-29	364	109	8	481	2021-03-13	male
30-34	672	117	10	799	2021-03-13	male
35-39	886	166	31	1083	2021-03-13	male
40-44	1144	227	51	1422	2021-03-13	male
45-49	1638	370	103	2111	2021-03-13	male
50-54	2176	465	181	2822	2021-03-13	male
55-59	2468	649	328	3445	2021-03-13	male
60-64	2498	692	565	3755	2021-03-13	male
65-69	2206	760	736	3702	2021-03-13	male
70-74	2630	1021	1188	4839	2021-03-13	male
75-79	2440	1159	1499	5098	2021-03-13	male
80-84	2135	1208	1714	5057	2021-03-13	male
85-89	1555	1065	1572	4192	2021-03-13	male
90+	872	650	1197	2719	2021-03-13	male
0-4	634	61	5	700	2021-03-13	all
5-9	154	29	0	183	2021-03-13	all
10-14	263	50	0	313	2021-03-13	all
15-19	453	91	3	547	2021-03-13	all
20-24	847	136	9	992	2021-03-13	all
25-29	1176	231	19	1426	2021-03-13	all
30-34	1754	275	20	2049	2021-03-13	all
35-39	1866	332	50	2248	2021-03-13	all
40-44	2031	407	84	2522	2021-03-13	all
45-49	2819	573	180	3572	2021-03-13	all
50-54	3800	753	291	4844	2021-03-13	all
55-59	4291	1017	519	5827	2021-03-13	all
60-64	4163	1121	857	6141	2021-03-13	all
65-69	3791	1285	1144	6220	2021-03-13	all
70-74	4552	1761	1895	8208	2021-03-13	all
75-79	4483	2032	2382	8897	2021-03-13	all
80-84	4230	2448	2833	9511	2021-03-13	all
85-89	3560	2311	2760	8631	2021-03-13	all
90+	2416	1748	2405	6569	2021-03-13	all
0-4	276	19	1	296	2021-03-15	female
5-9	73	16	0	89	2021-03-15	female
10-14	133	24	0	157	2021-03-15	female
15-19	282	44	3	329	2021-03-15	female
20-24	596	75	3	674	2021-03-15	female
25-29	814	122	11	947	2021-03-15	female
30-34	1087	158	10	1255	2021-03-15	female
35-39	981	166	19	1166	2021-03-15	female
40-44	890	180	34	1104	2021-03-15	female
45-49	1181	204	77	1462	2021-03-15	female
50-54	1626	288	110	2024	2021-03-15	female
55-59	1830	368	191	2389	2021-03-15	female
60-64	1669	430	294	2393	2021-03-15	female
65-69	1591	526	409	2526	2021-03-15	female
70-74	1923	740	708	3371	2021-03-15	female
75-79	2045	875	886	3806	2021-03-15	female
80-84	2100	1241	1121	4462	2021-03-15	female
85-89	2007	1248	1192	4447	2021-03-15	female
90+	1550	1101	1214	3865	2021-03-15	female
0-4	359	43	4	406	2021-03-15	male
5-9	81	13	0	94	2021-03-15	male
10-14	130	26	0	156	2021-03-15	male
15-19	171	47	0	218	2021-03-15	male
20-24	252	61	6	319	2021-03-15	male
25-29	365	110	8	483	2021-03-15	male
30-34	673	117	10	800	2021-03-15	male
35-39	891	166	31	1088	2021-03-15	male
40-44	1147	227	51	1425	2021-03-15	male
45-49	1639	370	103	2112	2021-03-15	male
50-54	2181	467	181	2829	2021-03-15	male
55-59	2475	651	328	3454	2021-03-15	male
60-64	2502	698	566	3766	2021-03-15	male
65-69	2209	762	737	3708	2021-03-15	male
70-74	2635	1025	1191	4851	2021-03-15	male
75-79	2442	1161	1503	5106	2021-03-15	male
80-84	2140	1213	1721	5074	2021-03-15	male
85-89	1557	1066	1573	4196	2021-03-15	male
90+	872	652	1198	2722	2021-03-15	male
0-4	635	62	5	702	2021-03-15	all
5-9	154	29	0	183	2021-03-15	all
10-14	263	50	0	313	2021-03-15	all
15-19	453	91	3	547	2021-03-15	all
20-24	848	136	9	993	2021-03-15	all
25-29	1179	232	19	1430	2021-03-15	all
30-34	1760	275	20	2055	2021-03-15	all
35-39	1872	332	50	2254	2021-03-15	all
40-44	2037	407	85	2529	2021-03-15	all
45-49	2820	574	180	3574	2021-03-15	all
50-54	3807	755	291	4853	2021-03-15	all
55-59	4305	1019	519	5843	2021-03-15	all
60-64	4171	1128	860	6159	2021-03-15	all
65-69	3800	1288	1146	6234	2021-03-15	all
70-74	4558	1765	1899	8222	2021-03-15	all
75-79	4487	2036	2389	8912	2021-03-15	all
80-84	4240	2454	2842	9536	2021-03-15	all
85-89	3564	2314	2765	8643	2021-03-15	all
90+	2422	1753	2412	6587	2021-03-15	all
0-4	278	19	1	298	2021-03-16	female
5-9	73	16	0	89	2021-03-16	female
10-14	133	24	0	157	2021-03-16	female
15-19	283	44	3	330	2021-03-16	female
20-24	599	76	3	678	2021-03-16	female
25-29	818	126	11	955	2021-03-16	female
30-34	1091	159	10	1260	2021-03-16	female
35-39	990	166	19	1175	2021-03-16	female
40-44	898	179	35	1112	2021-03-16	female
45-49	1189	206	79	1474	2021-03-16	female
50-54	1636	288	114	2038	2021-03-16	female
55-59	1839	370	192	2401	2021-03-16	female
60-64	1680	434	296	2410	2021-03-16	female
65-69	1605	527	415	2547	2021-03-16	female
70-74	1933	748	711	3392	2021-03-16	female
75-79	2060	884	896	3840	2021-03-16	female
80-84	2116	1248	1134	4498	2021-03-16	female
85-89	2025	1264	1205	4494	2021-03-16	female
90+	1570	1106	1224	3900	2021-03-16	female
0-4	364	42	4	410	2021-03-16	male
5-9	82	13	0	95	2021-03-16	male
10-14	130	26	0	156	2021-03-16	male
15-19	171	49	0	220	2021-03-16	male
20-24	255	64	6	325	2021-03-16	male
25-29	370	110	8	488	2021-03-16	male
30-34	677	118	10	805	2021-03-16	male
35-39	898	167	32	1097	2021-03-16	male
40-44	1161	228	51	1440	2021-03-16	male
45-49	1653	371	103	2127	2021-03-16	male
50-54	2193	470	182	2845	2021-03-16	male
55-59	2501	656	333	3490	2021-03-16	male
60-64	2521	706	574	3801	2021-03-16	male
65-69	2222	768	743	3733	2021-03-16	male
70-74	2655	1038	1199	4892	2021-03-16	male
75-79	2456	1171	1516	5143	2021-03-16	male
80-84	2153	1230	1737	5120	2021-03-16	male
85-89	1564	1075	1590	4229	2021-03-16	male
90+	880	657	1209	2746	2021-03-16	male
0-4	642	61	5	708	2021-03-16	all
5-9	155	29	0	184	2021-03-16	all
10-14	263	50	0	313	2021-03-16	all
15-19	454	93	3	550	2021-03-16	all
20-24	854	140	9	1003	2021-03-16	all
25-29	1188	236	19	1443	2021-03-16	all
30-34	1768	277	20	2065	2021-03-16	all
35-39	1888	333	51	2272	2021-03-16	all
40-44	2059	407	86	2552	2021-03-16	all
45-49	2842	577	182	3601	2021-03-16	all
50-54	3829	758	296	4883	2021-03-16	all
55-59	4340	1026	525	5891	2021-03-16	all
60-64	4201	1140	870	6211	2021-03-16	all
65-69	3827	1295	1158	6280	2021-03-16	all
70-74	4588	1786	1910	8284	2021-03-16	all
75-79	4516	2055	2412	8983	2021-03-16	all
80-84	4269	2478	2871	9618	2021-03-16	all
85-89	3589	2339	2795	8723	2021-03-16	all
90+	2450	1763	2433	6646	2021-03-16	all
0-4	282	19	1	302	2021-03-17	female
5-9	73	16	0	89	2021-03-17	female
10-14	134	23	0	157	2021-03-17	female
15-19	287	44	3	334	2021-03-17	female
20-24	602	76	3	681	2021-03-17	female
25-29	822	126	11	959	2021-03-17	female
30-34	1097	159	11	1267	2021-03-17	female
35-39	993	166	19	1178	2021-03-17	female
40-44	903	182	35	1120	2021-03-17	female
45-49	1198	209	81	1488	2021-03-17	female
50-54	1650	291	117	2058	2021-03-17	female
55-59	1852	374	195	2421	2021-03-17	female
60-64	1699	439	302	2440	2021-03-17	female
65-69	1623	531	424	2578	2021-03-17	female
70-74	1946	761	719	3426	2021-03-17	female
75-79	2081	889	904	3874	2021-03-17	female
80-84	2132	1258	1143	4533	2021-03-17	female
85-89	2045	1269	1214	4528	2021-03-17	female
90+	1587	1112	1234	3933	2021-03-17	female
0-4	368	42	4	414	2021-03-17	male
5-9	82	13	0	95	2021-03-17	male
10-14	132	26	0	158	2021-03-17	male
15-19	173	49	0	222	2021-03-17	male
20-24	255	65	6	326	2021-03-17	male
25-29	371	111	8	490	2021-03-17	male
30-34	680	119	10	809	2021-03-17	male
35-39	905	170	32	1107	2021-03-17	male
40-44	1177	229	51	1457	2021-03-17	male
45-49	1663	374	105	2142	2021-03-17	male
50-54	2217	478	184	2879	2021-03-17	male
55-59	2528	666	345	3539	2021-03-17	male
60-64	2545	712	584	3841	2021-03-17	male
65-69	2239	774	752	3765	2021-03-17	male
70-74	2667	1049	1210	4926	2021-03-17	male
75-79	2476	1177	1532	5185	2021-03-17	male
80-84	2171	1244	1748	5163	2021-03-17	male
85-89	1578	1087	1601	4266	2021-03-17	male
90+	883	667	1216	2766	2021-03-17	male
0-4	650	61	5	716	2021-03-17	all
5-9	155	29	0	184	2021-03-17	all
10-14	266	49	0	315	2021-03-17	all
15-19	460	93	3	556	2021-03-17	all
20-24	857	141	9	1007	2021-03-17	all
25-29	1193	237	19	1449	2021-03-17	all
30-34	1777	278	21	2076	2021-03-17	all
35-39	1898	336	51	2285	2021-03-17	all
40-44	2080	411	86	2577	2021-03-17	all
45-49	2861	583	186	3630	2021-03-17	all
50-54	3867	769	301	4937	2021-03-17	all
55-59	4380	1040	540	5960	2021-03-17	all
60-64	4244	1151	886	6281	2021-03-17	all
65-69	3862	1305	1176	6343	2021-03-17	all
70-74	4613	1810	1929	8352	2021-03-17	all
75-79	4557	2066	2436	9059	2021-03-17	all
80-84	4303	2502	2891	9696	2021-03-17	all
85-89	3623	2356	2815	8794	2021-03-17	all
90+	2470	1779	2450	6699	2021-03-17	all
0-4	282	19	1	302	2021-03-17	female
5-9	73	16	0	89	2021-03-17	female
10-14	134	23	0	157	2021-03-17	female
15-19	287	44	3	334	2021-03-17	female
20-24	602	76	3	681	2021-03-17	female
25-29	822	126	11	959	2021-03-17	female
30-34	1097	159	11	1267	2021-03-17	female
35-39	993	166	19	1178	2021-03-17	female
40-44	903	182	35	1120	2021-03-17	female
45-49	1198	209	81	1488	2021-03-17	female
50-54	1650	291	117	2058	2021-03-17	female
55-59	1852	374	195	2421	2021-03-17	female
60-64	1699	439	302	2440	2021-03-17	female
65-69	1623	531	424	2578	2021-03-17	female
70-74	1946	761	719	3426	2021-03-17	female
75-79	2081	889	904	3874	2021-03-17	female
80-84	2132	1258	1143	4533	2021-03-17	female
85-89	2045	1269	1214	4528	2021-03-17	female
90+	1587	1112	1234	3933	2021-03-17	female
0-4	368	42	4	414	2021-03-17	male
5-9	82	13	0	95	2021-03-17	male
10-14	132	26	0	158	2021-03-17	male
15-19	173	49	0	222	2021-03-17	male
20-24	255	65	6	326	2021-03-17	male
25-29	371	111	8	490	2021-03-17	male
30-34	680	119	10	809	2021-03-17	male
35-39	905	170	32	1107	2021-03-17	male
40-44	1177	229	51	1457	2021-03-17	male
45-49	1663	374	105	2142	2021-03-17	male
50-54	2217	478	184	2879	2021-03-17	male
55-59	2528	666	345	3539	2021-03-17	male
60-64	2545	712	584	3841	2021-03-17	male
65-69	2239	774	752	3765	2021-03-17	male
70-74	2667	1049	1210	4926	2021-03-17	male
75-79	2476	1177	1532	5185	2021-03-17	male
80-84	2171	1244	1748	5163	2021-03-17	male
85-89	1578	1087	1601	4266	2021-03-17	male
90+	883	667	1216	2766	2021-03-17	male
0-4	650	61	5	716	2021-03-17	all
5-9	155	29	0	184	2021-03-17	all
10-14	266	49	0	315	2021-03-17	all
15-19	460	93	3	556	2021-03-17	all
20-24	857	141	9	1007	2021-03-17	all
25-29	1193	237	19	1449	2021-03-17	all
30-34	1777	278	21	2076	2021-03-17	all
35-39	1898	336	51	2285	2021-03-17	all
40-44	2080	411	86	2577	2021-03-17	all
45-49	2861	583	186	3630	2021-03-17	all
50-54	3867	769	301	4937	2021-03-17	all
55-59	4380	1040	540	5960	2021-03-17	all
60-64	4244	1151	886	6281	2021-03-17	all
65-69	3862	1305	1176	6343	2021-03-17	all
70-74	4613	1810	1929	8352	2021-03-17	all
75-79	4557	2066	2436	9059	2021-03-17	all
80-84	4303	2502	2891	9696	2021-03-17	all
85-89	3623	2356	2815	8794	2021-03-17	all
90+	2470	1779	2450	6699	2021-03-17	all
0-4	282	19	1	302	2021-03-17	female
5-9	73	16	0	89	2021-03-17	female
10-14	134	23	0	157	2021-03-17	female
15-19	287	44	3	334	2021-03-17	female
20-24	602	76	3	681	2021-03-17	female
25-29	822	126	11	959	2021-03-17	female
30-34	1097	159	11	1267	2021-03-17	female
35-39	993	166	19	1178	2021-03-17	female
40-44	903	182	35	1120	2021-03-17	female
45-49	1198	209	81	1488	2021-03-17	female
50-54	1650	291	117	2058	2021-03-17	female
55-59	1852	374	195	2421	2021-03-17	female
60-64	1699	439	302	2440	2021-03-17	female
65-69	1623	531	424	2578	2021-03-17	female
70-74	1946	761	719	3426	2021-03-17	female
75-79	2081	889	904	3874	2021-03-17	female
80-84	2132	1258	1143	4533	2021-03-17	female
85-89	2045	1269	1214	4528	2021-03-17	female
90+	1587	1112	1234	3933	2021-03-17	female
0-4	368	42	4	414	2021-03-17	male
5-9	82	13	0	95	2021-03-17	male
10-14	132	26	0	158	2021-03-17	male
15-19	173	49	0	222	2021-03-17	male
20-24	255	65	6	326	2021-03-17	male
25-29	371	111	8	490	2021-03-17	male
30-34	680	119	10	809	2021-03-17	male
35-39	905	170	32	1107	2021-03-17	male
40-44	1177	229	51	1457	2021-03-17	male
45-49	1663	374	105	2142	2021-03-17	male
50-54	2217	478	184	2879	2021-03-17	male
55-59	2528	666	345	3539	2021-03-17	male
60-64	2545	712	584	3841	2021-03-17	male
65-69	2239	774	752	3765	2021-03-17	male
70-74	2667	1049	1210	4926	2021-03-17	male
75-79	2476	1177	1532	5185	2021-03-17	male
80-84	2171	1244	1748	5163	2021-03-17	male
85-89	1578	1087	1601	4266	2021-03-17	male
90+	883	667	1216	2766	2021-03-17	male
0-4	650	61	5	716	2021-03-17	all
5-9	155	29	0	184	2021-03-17	all
10-14	266	49	0	315	2021-03-17	all
15-19	460	93	3	556	2021-03-17	all
20-24	857	141	9	1007	2021-03-17	all
25-29	1193	237	19	1449	2021-03-17	all
30-34	1777	278	21	2076	2021-03-17	all
35-39	1898	336	51	2285	2021-03-17	all
40-44	2080	411	86	2577	2021-03-17	all
45-49	2861	583	186	3630	2021-03-17	all
50-54	3867	769	301	4937	2021-03-17	all
55-59	4380	1040	540	5960	2021-03-17	all
60-64	4244	1151	886	6281	2021-03-17	all
65-69	3862	1305	1176	6343	2021-03-17	all
70-74	4613	1810	1929	8352	2021-03-17	all
75-79	4557	2066	2436	9059	2021-03-17	all
80-84	4303	2502	2891	9696	2021-03-17	all
85-89	3623	2356	2815	8794	2021-03-17	all
90+	2470	1779	2450	6699	2021-03-17	all
0-4	282	19	1	302	2021-03-17	female
5-9	73	16	0	89	2021-03-17	female
10-14	134	23	0	157	2021-03-17	female
15-19	287	44	3	334	2021-03-17	female
20-24	602	76	3	681	2021-03-17	female
25-29	822	126	11	959	2021-03-17	female
30-34	1097	159	11	1267	2021-03-17	female
35-39	993	166	19	1178	2021-03-17	female
40-44	903	182	35	1120	2021-03-17	female
45-49	1198	209	81	1488	2021-03-17	female
50-54	1650	291	117	2058	2021-03-17	female
55-59	1852	374	195	2421	2021-03-17	female
60-64	1699	439	302	2440	2021-03-17	female
65-69	1623	531	424	2578	2021-03-17	female
70-74	1946	761	719	3426	2021-03-17	female
75-79	2081	889	904	3874	2021-03-17	female
80-84	2132	1258	1143	4533	2021-03-17	female
85-89	2045	1269	1214	4528	2021-03-17	female
90+	1587	1112	1234	3933	2021-03-17	female
0-4	368	42	4	414	2021-03-17	male
5-9	82	13	0	95	2021-03-17	male
10-14	132	26	0	158	2021-03-17	male
15-19	173	49	0	222	2021-03-17	male
20-24	255	65	6	326	2021-03-17	male
25-29	371	111	8	490	2021-03-17	male
30-34	680	119	10	809	2021-03-17	male
35-39	905	170	32	1107	2021-03-17	male
40-44	1177	229	51	1457	2021-03-17	male
45-49	1663	374	105	2142	2021-03-17	male
50-54	2217	478	184	2879	2021-03-17	male
55-59	2528	666	345	3539	2021-03-17	male
60-64	2545	712	584	3841	2021-03-17	male
65-69	2239	774	752	3765	2021-03-17	male
70-74	2667	1049	1210	4926	2021-03-17	male
75-79	2476	1177	1532	5185	2021-03-17	male
80-84	2171	1244	1748	5163	2021-03-17	male
85-89	1578	1087	1601	4266	2021-03-17	male
90+	883	667	1216	2766	2021-03-17	male
0-4	650	61	5	716	2021-03-17	all
5-9	155	29	0	184	2021-03-17	all
10-14	266	49	0	315	2021-03-17	all
15-19	460	93	3	556	2021-03-17	all
20-24	857	141	9	1007	2021-03-17	all
25-29	1193	237	19	1449	2021-03-17	all
30-34	1777	278	21	2076	2021-03-17	all
35-39	1898	336	51	2285	2021-03-17	all
40-44	2080	411	86	2577	2021-03-17	all
45-49	2861	583	186	3630	2021-03-17	all
50-54	3867	769	301	4937	2021-03-17	all
55-59	4380	1040	540	5960	2021-03-17	all
60-64	4244	1151	886	6281	2021-03-17	all
65-69	3862	1305	1176	6343	2021-03-17	all
70-74	4613	1810	1929	8352	2021-03-17	all
75-79	4557	2066	2436	9059	2021-03-17	all
80-84	4303	2502	2891	9696	2021-03-17	all
85-89	3623	2356	2815	8794	2021-03-17	all
90+	2470	1779	2450	6699	2021-03-17	all
0-4	282	19	1	302	2021-03-17	female
5-9	73	16	0	89	2021-03-17	female
10-14	134	23	0	157	2021-03-17	female
15-19	287	44	3	334	2021-03-17	female
20-24	602	76	3	681	2021-03-17	female
25-29	822	126	11	959	2021-03-17	female
30-34	1097	159	11	1267	2021-03-17	female
35-39	993	166	19	1178	2021-03-17	female
40-44	903	182	35	1120	2021-03-17	female
45-49	1198	209	81	1488	2021-03-17	female
50-54	1650	291	117	2058	2021-03-17	female
55-59	1852	374	195	2421	2021-03-17	female
60-64	1699	439	302	2440	2021-03-17	female
65-69	1623	531	424	2578	2021-03-17	female
70-74	1946	761	719	3426	2021-03-17	female
75-79	2081	889	904	3874	2021-03-17	female
80-84	2132	1258	1143	4533	2021-03-17	female
85-89	2045	1269	1214	4528	2021-03-17	female
90+	1587	1112	1234	3933	2021-03-17	female
0-4	368	42	4	414	2021-03-17	male
5-9	82	13	0	95	2021-03-17	male
10-14	132	26	0	158	2021-03-17	male
15-19	173	49	0	222	2021-03-17	male
20-24	255	65	6	326	2021-03-17	male
25-29	371	111	8	490	2021-03-17	male
30-34	680	119	10	809	2021-03-17	male
35-39	905	170	32	1107	2021-03-17	male
40-44	1177	229	51	1457	2021-03-17	male
45-49	1663	374	105	2142	2021-03-17	male
50-54	2217	478	184	2879	2021-03-17	male
55-59	2528	666	345	3539	2021-03-17	male
60-64	2545	712	584	3841	2021-03-17	male
65-69	2239	774	752	3765	2021-03-17	male
70-74	2667	1049	1210	4926	2021-03-17	male
75-79	2476	1177	1532	5185	2021-03-17	male
80-84	2171	1244	1748	5163	2021-03-17	male
85-89	1578	1087	1601	4266	2021-03-17	male
90+	883	667	1216	2766	2021-03-17	male
0-4	650	61	5	716	2021-03-17	all
5-9	155	29	0	184	2021-03-17	all
10-14	266	49	0	315	2021-03-17	all
15-19	460	93	3	556	2021-03-17	all
20-24	857	141	9	1007	2021-03-17	all
25-29	1193	237	19	1449	2021-03-17	all
30-34	1777	278	21	2076	2021-03-17	all
35-39	1898	336	51	2285	2021-03-17	all
40-44	2080	411	86	2577	2021-03-17	all
45-49	2861	583	186	3630	2021-03-17	all
50-54	3867	769	301	4937	2021-03-17	all
55-59	4380	1040	540	5960	2021-03-17	all
60-64	4244	1151	886	6281	2021-03-17	all
65-69	3862	1305	1176	6343	2021-03-17	all
70-74	4613	1810	1929	8352	2021-03-17	all
75-79	4557	2066	2436	9059	2021-03-17	all
80-84	4303	2502	2891	9696	2021-03-17	all
85-89	3623	2356	2815	8794	2021-03-17	all
90+	2470	1779	2450	6699	2021-03-17	all
0-4	282	19	1	302	2021-03-17	female
5-9	73	16	0	89	2021-03-17	female
10-14	134	23	0	157	2021-03-17	female
15-19	287	44	3	334	2021-03-17	female
20-24	602	76	3	681	2021-03-17	female
25-29	822	126	11	959	2021-03-17	female
30-34	1097	159	11	1267	2021-03-17	female
35-39	993	166	19	1178	2021-03-17	female
40-44	903	182	35	1120	2021-03-17	female
45-49	1198	209	81	1488	2021-03-17	female
50-54	1650	291	117	2058	2021-03-17	female
55-59	1852	374	195	2421	2021-03-17	female
60-64	1699	439	302	2440	2021-03-17	female
65-69	1623	531	424	2578	2021-03-17	female
70-74	1946	761	719	3426	2021-03-17	female
75-79	2081	889	904	3874	2021-03-17	female
80-84	2132	1258	1143	4533	2021-03-17	female
85-89	2045	1269	1214	4528	2021-03-17	female
90+	1587	1112	1234	3933	2021-03-17	female
0-4	368	42	4	414	2021-03-17	male
5-9	82	13	0	95	2021-03-17	male
10-14	132	26	0	158	2021-03-17	male
15-19	173	49	0	222	2021-03-17	male
20-24	255	65	6	326	2021-03-17	male
25-29	371	111	8	490	2021-03-17	male
30-34	680	119	10	809	2021-03-17	male
35-39	905	170	32	1107	2021-03-17	male
40-44	1177	229	51	1457	2021-03-17	male
45-49	1663	374	105	2142	2021-03-17	male
50-54	2217	478	184	2879	2021-03-17	male
55-59	2528	666	345	3539	2021-03-17	male
60-64	2545	712	584	3841	2021-03-17	male
65-69	2239	774	752	3765	2021-03-17	male
70-74	2667	1049	1210	4926	2021-03-17	male
75-79	2476	1177	1532	5185	2021-03-17	male
80-84	2171	1244	1748	5163	2021-03-17	male
85-89	1578	1087	1601	4266	2021-03-17	male
90+	883	667	1216	2766	2021-03-17	male
0-4	650	61	5	716	2021-03-17	all
5-9	155	29	0	184	2021-03-17	all
10-14	266	49	0	315	2021-03-17	all
15-19	460	93	3	556	2021-03-17	all
20-24	857	141	9	1007	2021-03-17	all
25-29	1193	237	19	1449	2021-03-17	all
30-34	1777	278	21	2076	2021-03-17	all
35-39	1898	336	51	2285	2021-03-17	all
40-44	2080	411	86	2577	2021-03-17	all
45-49	2861	583	186	3630	2021-03-17	all
50-54	3867	769	301	4937	2021-03-17	all
55-59	4380	1040	540	5960	2021-03-17	all
60-64	4244	1151	886	6281	2021-03-17	all
65-69	3862	1305	1176	6343	2021-03-17	all
70-74	4613	1810	1929	8352	2021-03-17	all
75-79	4557	2066	2436	9059	2021-03-17	all
80-84	4303	2502	2891	9696	2021-03-17	all
85-89	3623	2356	2815	8794	2021-03-17	all
90+	2470	1779	2450	6699	2021-03-17	all
0-4	282	19	1	302	2021-03-17	female
5-9	73	16	0	89	2021-03-17	female
10-14	134	23	0	157	2021-03-17	female
15-19	287	44	3	334	2021-03-17	female
20-24	602	76	3	681	2021-03-17	female
25-29	822	126	11	959	2021-03-17	female
30-34	1097	159	11	1267	2021-03-17	female
35-39	993	166	19	1178	2021-03-17	female
40-44	903	182	35	1120	2021-03-17	female
45-49	1198	209	81	1488	2021-03-17	female
50-54	1650	291	117	2058	2021-03-17	female
55-59	1852	374	195	2421	2021-03-17	female
60-64	1699	439	302	2440	2021-03-17	female
65-69	1623	531	424	2578	2021-03-17	female
70-74	1946	761	719	3426	2021-03-17	female
75-79	2081	889	904	3874	2021-03-17	female
80-84	2132	1258	1143	4533	2021-03-17	female
85-89	2045	1269	1214	4528	2021-03-17	female
90+	1587	1112	1234	3933	2021-03-17	female
0-4	368	42	4	414	2021-03-17	male
5-9	82	13	0	95	2021-03-17	male
10-14	132	26	0	158	2021-03-17	male
15-19	173	49	0	222	2021-03-17	male
20-24	255	65	6	326	2021-03-17	male
25-29	371	111	8	490	2021-03-17	male
30-34	680	119	10	809	2021-03-17	male
35-39	905	170	32	1107	2021-03-17	male
40-44	1177	229	51	1457	2021-03-17	male
45-49	1663	374	105	2142	2021-03-17	male
50-54	2217	478	184	2879	2021-03-17	male
55-59	2528	666	345	3539	2021-03-17	male
60-64	2545	712	584	3841	2021-03-17	male
65-69	2239	774	752	3765	2021-03-17	male
70-74	2667	1049	1210	4926	2021-03-17	male
75-79	2476	1177	1532	5185	2021-03-17	male
80-84	2171	1244	1748	5163	2021-03-17	male
85-89	1578	1087	1601	4266	2021-03-17	male
90+	883	667	1216	2766	2021-03-17	male
0-4	650	61	5	716	2021-03-17	all
5-9	155	29	0	184	2021-03-17	all
10-14	266	49	0	315	2021-03-17	all
15-19	460	93	3	556	2021-03-17	all
20-24	857	141	9	1007	2021-03-17	all
25-29	1193	237	19	1449	2021-03-17	all
30-34	1777	278	21	2076	2021-03-17	all
35-39	1898	336	51	2285	2021-03-17	all
40-44	2080	411	86	2577	2021-03-17	all
45-49	2861	583	186	3630	2021-03-17	all
50-54	3867	769	301	4937	2021-03-17	all
55-59	4380	1040	540	5960	2021-03-17	all
60-64	4244	1151	886	6281	2021-03-17	all
65-69	3862	1305	1176	6343	2021-03-17	all
70-74	4613	1810	1929	8352	2021-03-17	all
75-79	4557	2066	2436	9059	2021-03-17	all
80-84	4303	2502	2891	9696	2021-03-17	all
85-89	3623	2356	2815	8794	2021-03-17	all
90+	2470	1779	2450	6699	2021-03-17	all
0-4	282	19	1	302	2021-03-17	female
5-9	73	16	0	89	2021-03-17	female
10-14	134	23	0	157	2021-03-17	female
15-19	287	44	3	334	2021-03-17	female
20-24	602	76	3	681	2021-03-17	female
25-29	822	126	11	959	2021-03-17	female
30-34	1097	159	11	1267	2021-03-17	female
35-39	993	166	19	1178	2021-03-17	female
40-44	903	182	35	1120	2021-03-17	female
45-49	1198	209	81	1488	2021-03-17	female
50-54	1650	291	117	2058	2021-03-17	female
55-59	1852	374	195	2421	2021-03-17	female
60-64	1699	439	302	2440	2021-03-17	female
65-69	1623	531	424	2578	2021-03-17	female
70-74	1946	761	719	3426	2021-03-17	female
75-79	2081	889	904	3874	2021-03-17	female
80-84	2132	1258	1143	4533	2021-03-17	female
85-89	2045	1269	1214	4528	2021-03-17	female
90+	1587	1112	1234	3933	2021-03-17	female
0-4	368	42	4	414	2021-03-17	male
5-9	82	13	0	95	2021-03-17	male
10-14	132	26	0	158	2021-03-17	male
15-19	173	49	0	222	2021-03-17	male
20-24	255	65	6	326	2021-03-17	male
25-29	371	111	8	490	2021-03-17	male
30-34	680	119	10	809	2021-03-17	male
35-39	905	170	32	1107	2021-03-17	male
40-44	1177	229	51	1457	2021-03-17	male
45-49	1663	374	105	2142	2021-03-17	male
50-54	2217	478	184	2879	2021-03-17	male
55-59	2528	666	345	3539	2021-03-17	male
60-64	2545	712	584	3841	2021-03-17	male
65-69	2239	774	752	3765	2021-03-17	male
70-74	2667	1049	1210	4926	2021-03-17	male
75-79	2476	1177	1532	5185	2021-03-17	male
80-84	2171	1244	1748	5163	2021-03-17	male
85-89	1578	1087	1601	4266	2021-03-17	male
90+	883	667	1216	2766	2021-03-17	male
0-4	650	61	5	716	2021-03-17	all
5-9	155	29	0	184	2021-03-17	all
10-14	266	49	0	315	2021-03-17	all
15-19	460	93	3	556	2021-03-17	all
20-24	857	141	9	1007	2021-03-17	all
25-29	1193	237	19	1449	2021-03-17	all
30-34	1777	278	21	2076	2021-03-17	all
35-39	1898	336	51	2285	2021-03-17	all
40-44	2080	411	86	2577	2021-03-17	all
45-49	2861	583	186	3630	2021-03-17	all
50-54	3867	769	301	4937	2021-03-17	all
55-59	4380	1040	540	5960	2021-03-17	all
60-64	4244	1151	886	6281	2021-03-17	all
65-69	3862	1305	1176	6343	2021-03-17	all
70-74	4613	1810	1929	8352	2021-03-17	all
75-79	4557	2066	2436	9059	2021-03-17	all
80-84	4303	2502	2891	9696	2021-03-17	all
85-89	3623	2356	2815	8794	2021-03-17	all
90+	2470	1779	2450	6699	2021-03-17	all
0-4	282	19	1	302	2021-03-17	female
5-9	73	16	0	89	2021-03-17	female
10-14	134	23	0	157	2021-03-17	female
15-19	287	44	3	334	2021-03-17	female
20-24	602	76	3	681	2021-03-17	female
25-29	822	126	11	959	2021-03-17	female
30-34	1097	159	11	1267	2021-03-17	female
35-39	993	166	19	1178	2021-03-17	female
40-44	903	182	35	1120	2021-03-17	female
45-49	1198	209	81	1488	2021-03-17	female
50-54	1650	291	117	2058	2021-03-17	female
55-59	1852	374	195	2421	2021-03-17	female
60-64	1699	439	302	2440	2021-03-17	female
65-69	1623	531	424	2578	2021-03-17	female
70-74	1946	761	719	3426	2021-03-17	female
75-79	2081	889	904	3874	2021-03-17	female
80-84	2132	1258	1143	4533	2021-03-17	female
85-89	2045	1269	1214	4528	2021-03-17	female
90+	1587	1112	1234	3933	2021-03-17	female
0-4	368	42	4	414	2021-03-17	male
5-9	82	13	0	95	2021-03-17	male
10-14	132	26	0	158	2021-03-17	male
15-19	173	49	0	222	2021-03-17	male
20-24	255	65	6	326	2021-03-17	male
25-29	371	111	8	490	2021-03-17	male
30-34	680	119	10	809	2021-03-17	male
35-39	905	170	32	1107	2021-03-17	male
40-44	1177	229	51	1457	2021-03-17	male
45-49	1663	374	105	2142	2021-03-17	male
50-54	2217	478	184	2879	2021-03-17	male
55-59	2528	666	345	3539	2021-03-17	male
60-64	2545	712	584	3841	2021-03-17	male
65-69	2239	774	752	3765	2021-03-17	male
70-74	2667	1049	1210	4926	2021-03-17	male
75-79	2476	1177	1532	5185	2021-03-17	male
80-84	2171	1244	1748	5163	2021-03-17	male
85-89	1578	1087	1601	4266	2021-03-17	male
90+	883	667	1216	2766	2021-03-17	male
0-4	650	61	5	716	2021-03-17	all
5-9	155	29	0	184	2021-03-17	all
10-14	266	49	0	315	2021-03-17	all
15-19	460	93	3	556	2021-03-17	all
20-24	857	141	9	1007	2021-03-17	all
25-29	1193	237	19	1449	2021-03-17	all
30-34	1777	278	21	2076	2021-03-17	all
35-39	1898	336	51	2285	2021-03-17	all
40-44	2080	411	86	2577	2021-03-17	all
45-49	2861	583	186	3630	2021-03-17	all
50-54	3867	769	301	4937	2021-03-17	all
55-59	4380	1040	540	5960	2021-03-17	all
60-64	4244	1151	886	6281	2021-03-17	all
65-69	3862	1305	1176	6343	2021-03-17	all
70-74	4613	1810	1929	8352	2021-03-17	all
75-79	4557	2066	2436	9059	2021-03-17	all
80-84	4303	2502	2891	9696	2021-03-17	all
85-89	3623	2356	2815	8794	2021-03-17	all
90+	2470	1779	2450	6699	2021-03-17	all
